Genre,Drama,Other,Family,Fiction,Action_Adventure,Horror,total
time,49,26,50,54,44,39,262
life,55,29,45,42,46,31,248
film,43,45,38,37,40,39,242
day,51,27,46,38,37,38,237
man,42,21,39,34,45,33,214
friend,36,19,49,39,36,35,214
father,38,26,52,29,32,34,211
year,47,22,35,41,30,30,205
death,38,16,23,39,35,45,196
love,36,25,52,25,28,17,183
night,28,9,23,35,35,51,181
son,35,24,29,20,44,24,176
family,32,21,36,21,35,29,174
way,27,12,32,35,28,35,169
home,33,18,30,32,28,28,169
house,30,16,31,19,27,42,165
wife,33,18,24,22,31,31,159
story,30,32,34,18,21,20,155
people,25,19,23,30,24,27,148
child,23,15,34,29,19,24,144
mother,22,13,32,25,17,31,140
daughter,30,17,32,14,25,22,140
girl,26,14,29,16,21,21,127
world,25,15,19,38,11,19,127
men,28,5,15,21,40,17,126
woman,23,12,19,18,21,31,124
order,28,5,19,23,33,14,122
attempt,19,7,24,28,22,21,121
body,19,5,9,23,19,43,118
hand,20,9,17,17,26,29,118
place,23,11,20,23,22,16,115
police,28,9,14,17,24,21,113
brother,20,10,20,13,31,19,113
help,15,7,22,21,17,28,110
room,18,3,15,22,13,37,108
city,21,14,14,23,24,12,108
group,19,7,9,25,30,18,108
scene,20,9,20,16,25,14,104
end,15,13,22,23,15,14,102
plan,21,8,14,11,25,21,100
war,23,12,11,15,24,12,97
part,15,8,19,19,20,15,96
town,12,7,11,12,27,25,94
boy,11,12,20,18,12,17,90
head,14,5,17,19,16,19,90
return,13,5,14,24,18,13,87
money,22,14,14,8,23,6,87
morning,21,1,15,18,16,16,87
attack,16,4,7,18,24,15,84
village,15,17,18,3,22,7,82
fire,20,5,6,11,22,17,81
name,15,4,20,11,19,12,81
rest,16,9,8,10,21,16,80
car,14,2,10,20,18,15,79
-,17,4,12,16,15,15,79
power,12,5,10,33,10,9,79
others,12,6,15,20,10,16,79
door,10,3,10,17,6,31,77
movie,15,12,18,7,10,14,76
member,20,6,8,14,15,12,75
sister,10,5,16,7,15,19,72
event,17,3,12,16,9,14,71
one,10,7,7,15,12,19,70
officer,22,4,8,13,20,3,70
doctor,12,7,12,16,4,19,70
gun,17,3,5,10,21,13,69
work,13,8,14,14,9,10,68
school,11,12,16,11,6,11,67
job,16,6,18,11,12,3,66
fight,9,5,13,14,20,5,66
marriage,13,7,27,2,12,5,66
dr.,10,3,4,25,4,20,66
party,15,1,10,14,12,14,66
heart,7,9,15,11,10,13,65
point,14,4,15,12,12,8,65
face,14,2,9,9,10,21,65
leader,14,6,3,10,21,10,64
husband,10,5,17,10,9,13,64
force,12,1,5,12,23,10,63
army,14,5,4,14,21,5,63
state,20,4,14,7,7,10,62
earth,4,4,7,37,6,3,61
battle,8,3,6,8,25,11,61
window,8,1,10,12,6,23,60
hospital,16,1,13,11,7,12,60
situation,14,6,9,10,15,6,60
building,16,4,3,16,10,10,59
relationship,11,6,8,15,10,9,59
arm,8,0,6,10,11,23,58
side,12,6,7,14,15,3,57
murder,15,3,5,4,12,18,57
truth,11,8,16,9,5,8,57
parent,12,7,20,6,3,9,57
person,9,8,11,6,11,11,56
suicide,14,3,10,7,11,11,56
self,7,4,7,21,9,7,55
water,8,2,12,14,12,7,55
law,12,1,9,9,18,6,55
word,11,3,15,7,10,9,55
thing,11,3,10,11,7,12,54
street,12,6,8,10,9,9,54
front,8,5,16,7,7,10,53
memory,11,4,10,17,5,6,53
new,13,9,4,15,4,7,52
student,8,6,11,6,5,16,52
control,9,2,4,18,12,7,52
gang,7,4,9,9,19,4,52
prison,15,4,6,6,11,9,51
captain,12,0,3,14,18,4,51
land,7,7,7,9,18,3,51
result,12,2,8,13,9,7,51
month,12,1,9,13,9,7,51
moment,7,1,13,13,9,8,51
process,8,1,11,12,7,12,51
mind,7,5,8,16,8,6,50
american,12,7,3,7,17,4,50
soldier,12,6,6,1,20,5,50
eye,8,7,9,10,3,13,50
action,13,3,8,11,11,4,50
news,11,8,7,10,8,5,49
office,12,6,8,5,10,8,49
revenge,11,4,4,4,10,15,48
dream,9,4,12,10,2,11,48
blood,2,1,5,5,11,24,48
letter,14,1,9,9,7,8,48
character,9,5,9,14,7,4,48
couple,5,6,16,8,3,9,47
ship,3,0,3,25,11,5,47
plot,8,8,11,5,7,8,47
act,13,4,10,1,11,8,47
crew,10,1,1,17,8,10,47
company,13,7,7,8,6,5,46
government,3,7,8,17,8,3,46
escape,15,0,3,10,5,13,46
guard,14,1,5,5,13,8,46
train,5,2,7,8,16,7,45
hope,10,3,10,8,8,6,45
machine,11,1,4,17,6,5,44
wall,6,2,4,7,9,16,44
past,8,3,7,13,8,5,44
identity,12,5,6,4,9,8,44
line,8,4,7,10,10,5,44
pair,4,3,8,8,10,11,44
space,4,1,3,32,1,3,44
wedding,5,4,16,6,8,4,43
search,6,5,6,9,11,6,43
ground,7,1,6,13,8,8,43
station,9,2,9,6,11,6,43
music,6,5,15,9,4,4,43
fact,8,6,4,8,8,9,43
number,7,3,8,14,6,5,43
owner,9,5,7,4,10,8,43
case,12,6,2,8,8,7,43
series,6,2,5,12,4,14,43
area,4,3,1,13,16,6,43
business,12,6,9,3,8,5,43
weapon,10,2,1,14,6,9,42
food,7,5,10,8,6,6,42
future,7,8,3,18,4,2,42
river,4,6,6,5,13,7,41
voice,4,6,10,6,7,8,41
struggle,7,5,7,6,5,11,41
lover,9,4,5,6,4,13,41
childhood,9,5,8,6,8,5,41
care,8,3,8,8,5,8,40
creature,2,1,4,19,2,12,40
effort,5,9,5,9,7,5,40
charge,14,1,3,4,14,4,40
king,7,5,9,5,10,4,40
trip,9,2,6,11,6,6,40
girlfriend,11,2,2,6,9,9,39
air,6,3,10,10,4,6,39
apartment,12,2,5,9,0,11,39
age,8,3,11,5,4,8,39
condition,8,3,9,5,8,6,39
problem,3,6,9,3,11,7,39
crime,16,1,3,4,8,6,38
form,3,4,8,11,2,10,38
mr.,7,3,6,8,6,8,38
meeting,16,0,5,9,4,4,38
piece,8,4,5,10,7,4,38
bed,4,1,7,9,4,12,37
mission,9,2,5,9,10,2,37
information,9,2,5,9,9,3,37
century,7,3,3,10,5,9,37
evening,4,1,8,6,6,12,37
note,10,1,6,7,9,4,37
book,6,2,4,10,3,11,36
worker,9,6,6,5,6,4,36
chance,5,2,9,7,6,7,36
journey,4,7,5,7,6,7,36
funeral,7,3,3,8,6,9,36
country,6,4,8,3,10,5,36
effect,5,4,4,13,0,10,36
agent,11,1,5,10,4,5,36
team,8,1,4,12,7,3,35
john,8,3,3,10,6,5,35
planet,1,2,1,28,2,1,35
wound,9,0,2,6,8,10,35
god,6,1,9,6,8,5,35
encounter,3,6,3,8,6,9,35
professor,3,2,6,13,1,9,34
prisoner,9,2,2,4,12,5,34
attention,7,1,7,8,8,3,34
reason,8,4,8,5,6,3,34
star,4,2,8,11,3,5,33
command,11,1,2,10,8,1,33
idea,4,3,15,8,1,2,33
camera,5,3,3,10,4,8,33
forest,2,3,6,9,8,5,33
incident,5,4,7,4,10,3,33
accident,4,4,6,10,3,6,33
chief,9,5,3,7,8,1,33
audience,5,3,6,9,3,7,33
united,7,3,3,10,6,4,33
tree,3,1,5,8,8,7,32
crowd,12,0,3,5,8,4,32
horse,3,1,4,6,14,4,32
uncle,6,7,7,2,8,2,32
road,4,4,8,6,4,6,32
show,8,2,8,6,3,5,32
interest,4,3,8,6,10,1,32
victim,8,2,2,4,4,12,32
call,10,1,3,7,3,8,32
affair,6,6,8,2,4,6,32
villager,5,6,5,3,11,2,32
back,10,1,6,6,2,7,32
survivor,3,1,1,9,10,8,32
game,12,4,4,3,3,5,31
witness,9,3,3,3,7,6,31
troop,8,2,1,3,17,0,31
career,9,4,7,4,3,4,31
song,5,6,11,5,2,2,31
class,3,5,10,2,5,6,31
fear,3,2,3,8,7,8,31
feeling,4,2,15,5,5,0,31
light,3,3,4,9,3,9,31
living,6,1,6,5,2,11,31
safety,3,1,3,10,6,8,31
top,4,2,6,7,6,6,31
service,5,6,3,6,9,2,31
sea,4,1,2,9,6,8,30
states,7,2,3,8,6,4,30
course,5,6,2,10,4,3,30
peace,7,3,3,3,8,6,30
camp,8,4,4,2,10,2,30
deal,8,2,6,5,6,3,30
visit,5,0,12,6,3,4,30
phone,8,2,2,5,5,8,30
bomb,11,1,2,12,2,2,30
director,5,9,3,6,1,6,30
term,5,2,8,5,6,4,30
chase,4,1,8,3,8,6,30
system,6,3,3,10,5,2,29
foot,5,2,6,2,9,5,29
danger,2,2,3,6,6,10,29
success,7,2,6,4,3,7,29
trouble,3,0,8,5,11,2,29
week,5,4,6,7,0,7,29
race,3,1,2,14,5,4,29
fate,3,5,5,9,2,5,29
human,3,0,4,14,2,6,29
rescue,2,1,4,11,5,6,29
york,9,5,1,7,2,5,29
sight,4,4,5,8,5,3,29
sound,3,1,6,9,4,6,29
ability,3,3,5,8,3,6,28
decision,7,7,3,3,7,1,28
behavior,3,1,5,5,10,4,28
bar,5,0,4,8,4,7,28
india,2,7,13,1,5,0,28
shot,3,0,5,9,9,2,28
change,7,3,6,6,0,6,28
monster,0,0,3,10,1,14,28
experience,4,4,4,6,5,5,28
device,3,1,0,21,2,1,28
nature,4,2,2,9,3,8,28
birth,6,3,7,4,2,6,28
knife,6,3,0,1,2,16,28
evidence,11,2,3,7,4,1,28
version,1,2,8,11,3,3,28
flight,6,1,4,6,6,4,27
truck,6,0,4,7,4,6,27
servant,5,3,8,4,2,5,27
report,6,3,2,7,3,6,27
cause,4,1,5,5,5,7,27
mountain,4,2,3,7,7,4,27
scientist,0,2,0,22,0,3,27
explosion,5,0,3,13,3,3,27
position,9,2,3,5,6,2,27
spirit,5,1,7,2,1,11,27
lieutenant,8,0,2,4,9,4,27
grave,5,0,1,3,4,14,27
ring,5,3,4,4,5,6,27
master,5,0,5,5,9,3,27
island,3,0,4,7,5,8,27
anger,5,4,7,2,8,1,27
enemy,10,2,3,1,11,0,27
floor,8,0,1,6,3,9,27
role,8,2,7,3,2,5,27
colleague,5,0,3,7,6,5,26
jail,8,2,4,0,6,6,26
stage,4,1,7,5,4,5,26
reality,5,3,3,7,4,4,26
dance,4,2,12,3,1,4,26
horror,4,1,2,5,0,14,26
loss,7,4,4,3,5,3,26
hero,5,2,1,6,8,4,26
victory,5,0,3,4,12,2,26
flashback,5,2,7,2,7,3,26
baby,6,0,6,4,6,4,26
guy,4,4,4,2,8,4,26
arrive,4,0,4,2,6,10,26
credit,6,0,7,7,2,4,26
freedom,4,1,10,3,6,2,26
turn,5,4,7,2,7,1,26
assistant,2,1,5,8,2,8,26
match,3,1,6,7,6,3,26
figure,5,2,1,3,3,11,25
exchange,6,2,6,4,5,2,25
u.s.,5,1,0,8,7,4,25
half,5,2,4,6,6,2,25
surprise,3,0,8,4,8,2,25
location,3,2,1,7,6,6,25
sword,5,0,3,3,11,3,25
driver,7,1,5,3,7,2,25
middle,4,2,3,3,6,7,25
court,6,5,6,0,7,1,25
friendship,8,5,2,6,4,0,25
corpse,3,0,2,4,3,13,25
advice,3,2,6,6,3,5,25
question,7,5,3,4,2,4,25
dog,3,0,4,6,2,10,25
drug,12,1,2,5,2,2,24
activity,5,3,2,5,5,4,24
wish,2,3,8,2,2,7,24
cat,3,3,4,6,2,6,24
minute,4,0,2,9,2,7,24
lord,5,0,6,0,8,5,24
conversation,4,0,5,9,4,2,24
presence,4,2,3,7,4,4,24
killer,6,1,0,3,8,6,24
opening,5,4,3,3,3,6,24
hour,4,4,2,7,5,2,24
shelter,6,1,6,5,4,2,24
operation,11,0,2,3,3,5,24
ii,9,2,0,4,4,5,24
german,11,1,2,1,6,3,24
partner,4,1,5,3,9,2,24
boat,6,0,4,6,2,6,24
priest,4,1,2,2,5,10,24
neck,3,0,1,3,5,12,24
shock,3,3,2,7,3,6,24
affection,6,5,4,2,6,1,24
offer,2,3,3,5,9,2,24
test,0,1,5,10,1,7,24
sex,5,1,0,10,1,7,24
castle,1,0,5,3,3,12,24
dinner,1,1,2,8,3,9,24
field,4,2,4,6,5,3,24
warning,6,3,1,5,3,6,24
minister,7,3,5,4,4,1,24
gold,2,3,3,5,10,1,24
bos,8,2,6,3,3,1,23
release,8,0,6,4,3,2,23
bank,8,2,3,1,6,3,23
soul,0,1,5,3,2,12,23
injury,4,1,2,4,2,10,23
art,1,3,8,5,5,1,23
performance,4,1,7,1,3,7,23
commander,5,0,2,6,8,2,23
trap,3,0,1,5,6,8,23
sign,7,0,3,4,4,5,23
british,2,3,6,3,8,1,23
society,2,5,3,7,2,4,23
general,9,1,1,5,7,0,23
request,8,0,6,3,2,4,23
break,5,2,2,4,5,5,23
while,6,0,4,4,5,4,23
health,2,2,5,5,3,6,23
indian,3,1,8,0,11,0,23
ensues,2,1,5,4,5,5,22
estate,7,3,2,4,2,4,22
hotel,6,1,4,3,4,4,22
travel,4,2,3,11,2,0,22
bridge,5,2,3,4,3,5,22
basement,4,1,2,5,0,10,22
shop,5,1,8,3,1,4,22
london,2,2,4,5,2,7,22
college,7,2,8,1,0,4,22
television,2,1,5,6,3,5,22
choice,3,2,5,4,5,3,22
mistake,2,2,9,5,2,2,22
knowledge,5,0,5,7,2,3,22
cell,5,0,1,4,6,6,22
security,5,2,0,5,6,4,22
lady,1,2,10,3,2,4,22
response,5,1,3,9,3,1,22
reporter,2,2,1,5,7,5,22
history,4,4,2,7,4,1,22
hill,2,0,6,6,2,6,22
teacher,4,2,7,1,1,7,22
temple,5,1,7,2,4,3,22
raid,8,2,2,3,4,3,22
will,3,2,5,4,3,4,21
support,4,4,3,0,7,3,21
site,3,1,4,4,3,6,21
destruction,5,1,2,10,1,2,21
message,2,0,2,8,4,5,21
treatment,7,2,6,2,1,3,21
pursuit,4,1,4,2,7,3,21
supply,5,0,1,5,6,4,21
run,3,0,6,3,6,3,21
authority,7,1,2,2,3,6,21
restaurant,7,2,6,3,2,1,21
hunter,3,1,3,2,7,5,21
youth,4,5,5,3,1,3,21
band,3,0,4,3,9,2,21
lack,3,1,2,5,7,3,21
energy,4,0,4,11,1,1,21
guilt,3,1,7,3,2,5,21
rage,5,1,3,2,3,7,21
gas,0,2,1,12,2,4,21
wood,1,1,1,4,4,10,21
contact,5,1,4,6,3,2,21
pilot,5,0,3,10,2,1,21
board,3,2,4,5,5,2,21
ocean,2,1,3,10,5,0,21
date,3,1,3,12,1,1,21
grandfather,2,3,7,2,3,3,20
mrs.,5,0,4,3,1,7,20
wake,3,2,3,4,3,5,20
argument,3,4,5,1,5,2,20
relative,8,1,5,1,4,1,20
lot,2,3,5,3,5,2,20
plane,5,0,5,5,3,2,20
resident,0,3,4,2,4,7,20
step,3,1,5,6,2,3,20
opportunity,7,0,6,1,4,2,20
beginning,7,2,3,4,3,1,20
community,6,6,2,2,2,2,20
newspaper,5,0,6,2,3,4,20
storm,1,0,3,9,2,5,20
table,1,1,3,6,4,5,20
climax,1,5,8,3,2,1,20
photograph,6,2,2,3,3,4,20
interview,5,8,2,0,5,0,20
promise,8,2,6,1,2,1,20
second,2,2,1,8,4,3,20
ceremony,2,1,7,4,2,4,20
thief,5,2,7,1,4,1,20
trial,5,2,3,4,5,1,20
english,1,1,3,5,9,1,20
singer,5,3,9,1,0,2,20
image,2,4,1,6,5,2,20
secret,3,2,3,3,6,3,20
watch,4,0,4,3,7,2,20
henry,3,2,3,5,3,4,20
investigation,6,1,2,3,3,5,20
record,4,3,0,5,5,3,20
arrival,1,1,4,5,7,2,20
bus,3,2,7,2,2,4,20
fighter,6,0,5,3,6,0,20
george,5,4,0,7,2,2,20
gift,5,0,5,5,3,2,20
defense,4,1,0,7,5,3,20
mouth,6,1,3,4,4,2,20
kid,3,3,6,3,2,2,19
park,3,5,4,4,2,1,19
execution,4,2,2,3,4,4,19
track,4,0,4,3,6,2,19
humanity,4,2,3,8,1,1,19
move,1,1,4,5,5,3,19
thanks,3,0,8,3,2,3,19
radio,2,1,4,5,2,5,19
good,0,2,3,6,2,6,19
property,3,3,2,3,6,2,19
set,1,1,2,4,3,8,19
leaf,2,1,6,3,2,5,19
object,2,1,0,8,2,6,19
picture,1,3,5,2,5,3,19
appearance,2,2,3,6,2,4,19
farmer,4,2,3,2,5,3,19
widow,8,3,3,3,1,1,19
training,4,3,3,2,4,3,19
university,3,2,7,3,0,4,19
use,4,2,2,7,1,3,19
eve,5,1,3,5,2,3,19
center,5,3,2,4,3,2,19
hair,1,1,2,6,3,6,19
leg,5,0,3,2,4,5,19
store,3,1,2,5,3,5,19
boyfriend,5,2,3,3,1,5,19
chaos,4,0,2,6,4,3,19
ex,4,0,3,2,5,5,19
sequence,2,1,4,7,1,4,19
pain,3,0,1,5,1,9,19
fortune,3,1,6,3,4,1,18
official,5,3,5,3,2,0,18
hall,3,2,2,3,1,7,18
theater,2,2,3,4,1,6,18
heir,3,2,6,1,3,3,18
inspector,0,0,6,2,3,7,18
remains,2,0,3,9,0,4,18
henchman,5,0,3,3,7,0,18
sky,2,1,2,8,3,2,18
title,4,1,5,1,4,3,18
bag,2,1,8,0,6,1,18
card,4,1,2,4,5,2,18
military,3,0,1,5,5,4,18
rebel,4,2,1,3,6,2,18
difficulty,3,5,4,3,1,2,18
moon,0,2,3,8,0,5,18
engagement,2,0,6,2,5,3,18
prince,3,1,7,2,4,1,18
birthday,6,2,5,4,0,1,18
kind,2,0,5,5,2,4,18
task,3,1,1,4,6,3,18
the united states,3,1,2,6,3,3,18
border,5,0,4,1,7,1,18
james,2,1,3,3,7,2,18
refuge,7,1,0,1,4,5,18
tom,6,0,1,3,5,3,18
panic,4,1,1,3,1,8,18
threat,5,2,2,2,3,4,18
box,2,0,8,1,0,7,18
study,1,4,7,3,3,0,18
laboratory,1,1,0,11,0,5,18
nurse,6,1,0,0,2,9,18
post,6,0,1,1,9,1,18
ghost,1,0,0,2,1,14,18
consequence,5,4,2,2,3,2,18
web,3,4,4,4,2,1,18
union,4,0,5,3,6,0,18
vision,3,1,1,6,2,5,18
wave,3,0,2,8,5,0,18
belief,5,3,4,1,1,3,17
matter,4,0,2,5,3,3,17
passenger,3,2,2,4,4,2,17
david,2,3,1,5,0,6,17
photo,6,0,2,1,4,4,17
duel,4,0,1,2,10,0,17
violence,4,1,2,3,3,4,17
frank,4,1,0,1,7,4,17
neighbor,6,0,2,3,2,4,17
glass,1,1,4,2,1,8,17
rock,1,0,5,4,5,2,17
fall,4,1,5,4,2,1,17
bedroom,2,1,2,2,1,9,17
artist,2,3,4,3,4,1,17
skill,3,2,6,0,5,1,17
national,4,4,2,2,4,1,17
research,1,2,1,7,1,5,17
french,7,0,2,3,5,0,17
hole,2,1,2,7,1,4,17
demand,5,0,3,3,3,3,17
pistol,5,0,0,3,6,3,17
science,2,0,1,10,1,3,17
favor,5,3,1,1,4,3,17
assistance,2,0,2,6,5,2,17
assault,4,0,1,4,6,2,17
corner,1,0,7,1,3,5,17
church,2,2,2,2,4,5,17
tank,7,0,1,6,2,1,17
unit,6,0,0,6,4,1,17
experiment,0,2,0,9,0,6,17
intelligence,5,0,4,5,2,1,17
project,3,3,2,5,0,4,17
bullet,5,1,0,1,6,4,17
screen,2,0,6,4,3,2,17
slave,6,1,1,1,5,3,17
desert,1,1,2,6,5,2,17
finger,4,1,1,2,2,7,17
surface,3,1,0,6,2,5,17
despair,2,2,4,3,1,5,17
actor,4,2,3,4,2,2,17
edge,1,1,4,4,4,3,17
west,2,1,3,4,6,1,17
alien,1,0,1,14,1,0,17
england,0,0,2,1,5,9,17
distance,2,0,3,4,6,2,17
east,4,1,3,1,3,5,17
tale,4,3,2,1,3,4,17
patient,5,0,5,1,0,6,17
talent,3,0,8,2,1,2,16
metal,3,1,2,6,0,4,16
arrest,9,0,3,1,3,0,16
scheme,2,0,4,3,3,4,16
thought,0,3,2,5,5,1,16
wing,2,2,5,1,4,2,16
ray,2,0,1,7,1,5,16
guest,3,0,2,3,2,6,16
roof,2,1,1,4,1,7,16
flame,1,1,2,4,3,5,16
concern,6,2,2,2,1,3,16
suit,3,1,2,5,3,2,16
account,5,2,1,4,3,1,16
manager,2,2,2,2,3,5,16
warrior,2,1,1,4,8,0,16
whereabouts,4,1,7,2,1,1,16
sun,1,2,2,6,0,5,16
rope,1,1,2,3,7,2,16
suspicion,3,2,2,0,2,7,16
sentence,11,1,1,2,1,0,16
stone,2,0,1,3,3,7,16
confrontation,4,1,2,3,3,3,16
robbery,7,1,0,2,5,1,16
flower,3,1,4,4,2,2,16
colonel,6,0,0,3,6,1,16
root,3,2,6,0,1,4,16
key,2,0,1,5,2,6,16
bill,4,1,2,2,6,1,16
brain,0,0,2,7,1,6,16
ride,2,0,4,2,6,2,16
illness,4,1,4,1,0,6,16
bond,4,3,3,1,2,3,16
judge,2,3,0,1,5,5,16
period,3,2,1,5,2,3,16
ball,1,1,3,4,2,5,16
clothes,5,0,2,4,4,1,16
need,4,1,5,2,3,1,16
mob,3,0,3,1,5,4,16
goodbye,2,0,4,4,4,2,16
van,2,2,0,4,2,6,16
answer,4,0,3,3,3,3,16
smile,0,0,3,6,4,3,16
statue,1,2,0,5,1,7,16
path,2,0,4,4,4,2,16
background,0,4,8,3,1,0,16
respect,5,3,2,0,4,2,16
bottle,0,0,4,5,2,4,15
robot,0,0,1,13,1,0,15
construction,3,1,3,2,5,1,15
existence,2,0,4,7,0,2,15
mask,2,1,1,3,1,7,15
accomplice,7,0,2,2,1,3,15
advance,4,2,1,5,2,1,15
criminal,7,0,2,2,3,1,15
hundred,3,0,1,3,4,4,15
play,4,1,1,3,1,5,15
duty,3,2,0,1,6,3,15
romance,2,1,7,1,3,1,15
program,3,1,1,6,2,2,15
entrance,0,0,2,6,2,5,15
billy,4,0,0,4,3,4,15
detail,3,2,3,2,3,2,15
noise,2,0,2,5,1,5,15
princess,1,2,3,4,2,3,15
signal,2,2,2,6,3,0,15
connection,3,2,2,4,2,2,15
palace,3,1,4,1,5,1,15
issue,4,5,1,2,3,0,15
chest,3,2,1,5,4,0,15
nephew,5,2,2,1,3,2,15
asylum,4,2,2,1,1,5,15
rifle,1,1,0,1,7,5,15
rain,1,0,7,3,1,3,15
throat,2,0,0,1,4,8,15
damage,3,0,2,6,3,1,15
hiding,6,1,2,1,4,1,15
witch,0,1,4,1,1,8,15
paul,3,3,1,2,3,3,15
present,2,0,4,6,1,2,15
co,2,2,1,3,6,1,15
mexican,3,2,0,0,8,2,15
footage,2,8,1,1,1,2,15
aid,5,1,1,2,5,1,15
being,0,2,2,3,3,5,15
queen,2,1,3,3,1,5,15
conflict,3,2,1,3,5,1,15
chamber,3,2,2,5,2,1,15
actress,4,0,2,2,1,6,15
businessman,3,3,2,2,4,1,15
tower,1,2,0,6,2,3,14
diary,3,1,1,4,2,3,14
possession,3,0,1,2,2,6,14
crash,0,1,2,7,3,1,14
airport,5,0,5,1,3,0,14
confronts,4,1,3,4,2,0,14
white,5,0,1,1,4,3,14
subject,0,4,2,5,0,3,14
start,2,2,2,0,8,0,14
mean,1,0,4,7,2,0,14
strike,7,0,2,4,1,0,14
re,1,1,2,5,4,1,14
cloud,2,2,2,7,0,1,14
rampage,2,0,3,6,0,3,14
dark,3,1,0,2,5,3,14
meantime,2,1,3,4,2,2,14
lab,2,0,0,8,0,4,14
spy,1,2,1,1,8,1,14
trail,0,1,0,2,5,6,14
native,0,2,1,3,5,3,14
faith,4,1,2,2,1,4,14
farm,3,3,3,3,1,1,14
sacrifice,4,1,1,2,3,3,14
adventure,1,2,4,5,0,2,14
.,6,1,2,0,4,1,14
bird,2,1,4,4,1,2,14
origin,1,1,1,7,2,2,14
coast,3,0,0,6,3,2,14
element,3,4,2,5,0,0,14
aunt,3,1,4,1,1,4,14
mirror,0,1,3,0,0,10,14
paper,3,1,4,4,2,0,14
defeat,1,3,2,2,6,0,14
language,1,1,6,2,3,1,14
richard,2,2,1,2,2,5,14
dead,1,0,0,1,4,8,14
staff,4,0,2,0,5,3,14
curse,0,0,4,0,2,8,14
resistance,4,0,1,5,4,0,14
count,3,0,1,1,0,9,14
desire,3,1,3,4,3,0,14
fan,3,1,5,2,3,0,14
spring,2,1,4,1,4,2,14
soviet,6,0,3,3,1,1,14
nazi,7,3,1,1,2,0,14
lake,3,1,1,5,1,3,14
factory,3,2,3,4,2,0,14
prostitute,2,4,1,1,4,2,14
companion,0,0,4,1,5,4,14
kingdom,3,3,3,3,1,1,14
ruin,2,0,2,4,2,4,14
drinking,1,0,3,3,2,5,14
protection,5,0,2,1,3,3,14
intention,3,0,2,1,4,3,13
novel,2,2,2,2,0,5,13
demon,1,0,1,1,1,9,13
jack,4,0,0,1,4,4,13
attitude,1,3,4,0,5,0,13
associate,6,2,0,2,0,3,13
tv,3,3,0,2,1,4,13
pool,1,2,4,1,2,3,13
bat,4,1,1,1,0,6,13
view,3,1,3,1,3,2,13
corps,4,0,1,2,4,2,13
destination,1,1,2,5,1,3,13
invasion,4,2,1,3,3,0,13
peter,3,1,1,3,2,3,13
base,3,0,0,5,4,1,13
rival,6,1,1,0,4,1,13
cave,1,0,5,5,2,0,13
writer,4,2,2,3,0,2,13
gangster,3,0,4,2,2,2,13
approach,2,0,2,3,3,3,13
equipment,1,0,2,4,4,2,13
fun,0,2,5,3,1,2,13
don,4,1,3,0,3,2,13
attacker,2,0,0,3,4,4,13
world war ii,6,1,0,2,1,3,13
movement,2,2,2,4,2,1,13
wind,3,0,3,2,4,1,13
acquaintance,2,0,6,0,3,2,13
tour,2,1,5,1,1,3,13
claim,1,1,0,1,6,4,13
animal,1,1,4,1,1,5,13
household,2,1,6,1,1,2,13
flees,3,0,2,4,2,2,13
target,2,0,0,2,7,2,13
robert,3,1,1,2,3,3,13
difference,3,2,5,2,1,0,13
disguise,3,2,3,1,2,2,13
reward,1,0,2,2,8,0,13
documentary,2,5,1,1,2,2,13
vessel,2,0,0,7,4,0,13
code,2,1,1,6,2,1,13
employee,3,1,3,2,1,3,13
paris,3,0,4,2,1,3,13
salesman,4,2,1,3,1,2,13
vehicle,2,0,1,3,3,4,13
challenge,2,2,2,0,7,0,13
adult,3,2,1,2,1,4,13
fuel,2,0,2,5,1,3,13
south,2,1,3,1,4,2,13
rocket,1,0,1,10,1,0,13
black,3,1,1,1,4,3,13
los,5,1,0,1,4,2,13
speech,4,3,4,0,1,1,13
tunnel,2,0,2,4,2,3,13
sense,2,4,4,1,2,0,13
beach,6,1,3,1,1,1,13
new york city,2,3,1,4,0,3,13
none,4,1,2,1,4,1,13
william,4,1,0,1,6,1,13
citizen,4,1,0,4,2,2,13
sneak,1,0,3,6,3,0,13
red,4,0,3,1,2,3,13
mexico,4,1,0,2,4,2,13
disease,2,4,2,1,1,3,13
zombie,0,0,0,1,0,12,13
vampire,0,0,0,0,0,13,13
clan,3,0,1,1,7,1,13
abuse,4,0,2,1,3,3,13
japan,4,0,1,4,3,1,13
source,1,0,2,5,3,2,13
grand,3,0,1,3,5,1,13
customer,1,1,4,5,0,2,13
lesson,4,1,4,1,0,2,12
medium,1,2,1,4,1,3,12
computer,3,0,0,7,1,1,12
costume,3,1,2,4,0,2,12
ash,2,0,2,2,1,5,12
department,7,0,0,2,2,1,12
combat,4,1,2,4,0,1,12
guise,2,2,1,4,0,3,12
musician,1,3,2,4,2,0,12
drink,1,0,4,0,3,4,12
bombing,6,1,1,1,3,0,12
inhabitant,1,2,2,5,1,1,12
creation,1,0,3,4,1,3,12
dawn,1,0,1,1,2,7,12
suggestion,1,2,1,4,1,3,12
torture,1,1,2,2,4,2,12
kitchen,2,1,2,2,0,5,12
max,3,1,2,2,0,4,12
bath,1,0,1,2,3,5,12
punishment,2,0,3,2,1,4,12
purpose,2,2,4,2,2,0,12
beast,0,0,1,5,1,5,12
share,4,1,1,1,5,0,12
engineer,2,0,3,5,2,0,12
leadership,4,0,1,3,4,0,12
mate,2,1,2,1,2,4,12
amount,3,0,1,4,4,0,12
stop,1,1,2,3,3,2,12
right,3,1,4,2,2,0,12
rule,1,0,3,2,4,2,12
lightning,0,0,2,5,1,4,12
emotion,1,0,1,7,1,2,12
hunt,0,0,1,3,4,4,12
plea,3,1,2,3,0,3,12
pressure,3,0,1,1,4,3,12
shore,2,0,1,4,4,1,12
viewer,1,2,1,4,2,2,12
new york,4,2,0,3,1,2,12
complex,2,2,5,2,0,1,12
rise,1,0,1,2,3,5,12
scream,0,0,2,2,0,8,12
population,1,0,1,7,1,2,12
sheriff,0,0,2,1,7,2,12
disappearance,0,1,4,5,1,1,12
germany,5,1,0,3,2,1,12
spell,0,0,4,1,1,6,12
ally,1,1,3,2,3,2,12
grief,3,0,6,2,0,1,12
nightmare,1,1,1,2,1,6,12
america,2,2,0,5,2,1,12
inmate,7,1,0,0,2,2,12
cover,2,1,3,2,4,0,12
manner,0,2,3,3,4,0,12
well,2,0,1,1,4,4,12
railway,1,1,3,1,5,1,12
shape,1,0,1,6,1,3,12
circumstance,5,1,1,4,0,1,12
killing,2,0,2,1,5,2,12
sarah,2,2,0,2,0,6,12
aircraft,3,0,3,5,1,0,12
journalist,1,4,2,2,2,1,12
epilogue,3,1,3,0,2,3,12
cut,1,0,2,2,4,2,11
bride,1,3,1,0,2,4,11
section,0,2,2,3,4,0,11
gunpoint,3,0,1,2,3,2,11
patron,3,0,2,2,2,2,11
shift,2,1,1,1,5,1,11
trade,5,0,3,0,3,0,11
landlord,1,3,2,1,4,0,11
angeles,5,0,0,1,3,2,11
infant,0,2,0,5,2,2,11
drive,2,0,1,5,3,0,11
traffic,2,0,1,4,3,1,11
dress,2,0,2,6,0,1,11
hold,2,2,2,1,2,2,11
cousin,1,2,4,3,1,0,11
style,0,1,3,2,4,1,11
resolve,1,0,2,2,3,3,11
gratitude,3,0,4,2,1,1,11
ice,0,0,2,2,2,5,11
shell,1,0,3,4,2,1,11
suffering,4,1,0,2,1,3,11
score,0,0,3,3,4,1,11
ritual,0,1,1,0,2,7,11
veteran,4,2,2,1,1,1,11
sport,0,1,6,1,2,1,11
elder,0,2,2,2,3,2,11
wolf,1,0,1,1,2,6,11
third,3,3,1,1,3,0,11
gate,1,0,1,2,3,4,11
charles,1,2,1,0,2,5,11
guide,1,0,3,2,3,2,11
drop,3,0,0,0,3,5,11
christmas,4,1,2,2,1,1,11
thousand,3,1,1,3,1,2,11
radiation,1,1,0,8,0,1,11
closing,2,1,2,2,3,1,11
us,2,3,4,1,1,0,11
model,1,1,3,5,1,0,11
sibling,2,1,2,2,1,3,11
corruption,5,0,3,0,3,0,11
protagonist,3,0,4,4,0,0,11
hatred,1,3,2,2,2,1,11
responsibility,1,1,3,3,2,1,11
recording,5,0,1,2,1,2,11
cost,5,2,2,1,1,0,11
chain,1,3,3,2,2,0,11
ear,2,2,2,0,3,2,11
dancer,4,2,4,0,0,1,11
innocence,5,1,1,0,3,1,11
observation,2,1,0,4,2,2,11
custody,3,2,1,2,3,0,11
technology,1,0,2,6,2,0,11
ending,1,0,3,3,0,4,11
sergeant,5,0,0,1,4,1,11
fish,2,1,2,3,2,1,11
transformation,2,0,3,1,1,4,11
michael,4,0,2,3,1,1,11
artillery,3,0,2,2,4,0,11
speed,2,0,2,4,2,1,11
festival,1,5,2,2,1,0,11
outlaw,0,0,1,2,7,1,11
video,1,2,1,1,3,3,11
production,2,0,3,1,1,4,11
president,3,1,0,2,2,3,11
iron,0,0,3,3,3,2,11
progress,1,1,3,2,2,2,11
confession,6,2,1,1,0,1,11
influence,3,1,0,2,4,1,11
practice,1,2,2,0,3,3,11
solution,2,3,1,1,0,4,11
level,2,2,1,5,0,1,11
murderer,1,1,2,1,2,4,11
sunlight,1,0,1,1,0,8,11
darkness,1,0,2,0,0,8,11
public,2,1,2,4,2,0,11
lawyer,2,1,4,2,1,1,11
france,3,0,1,3,3,1,11
engine,0,0,0,5,4,2,11
thomas,2,0,2,1,4,2,11
wealth,5,0,2,0,4,0,11
plant,1,1,1,5,0,3,11
thug,3,0,2,1,5,0,11
atmosphere,1,0,0,7,1,2,11
betrayal,5,0,2,0,4,0,11
passage,1,2,0,4,1,3,11
snow,2,1,0,1,2,5,11
dancing,2,2,6,0,0,1,11
years,1,2,4,0,2,2,11
club,1,0,1,3,2,4,11
magazine,4,2,1,3,0,1,11
washington,6,0,1,1,2,1,11
honor,3,0,2,3,2,1,11
wheelchair,5,1,2,1,0,2,11
treasure,0,0,2,2,5,2,11
beauty,2,1,5,1,0,2,11
midnight,1,1,1,1,1,6,11
explosive,6,1,0,1,3,0,11
player,5,0,4,1,1,0,11
scott,1,2,0,5,1,2,11
de,3,1,1,3,2,1,11
expert,1,2,2,3,3,0,11
europe,3,0,1,1,2,3,10
value,2,3,3,2,0,0,10
mercy,3,0,1,0,5,1,10
map,0,0,0,4,3,3,10
mansion,2,0,3,2,1,2,10
mary,1,2,1,4,0,2,10
loan,2,2,5,0,0,1,10
local,1,1,0,0,2,6,10
grandmother,1,1,4,1,1,2,10
ambition,0,4,3,2,1,0,10
celebration,0,0,2,2,3,3,10
raja,2,6,1,0,1,0,10
cross,1,0,2,2,2,3,10
sleep,1,0,2,3,0,4,10
luck,1,0,0,1,5,3,10
failure,4,0,3,1,2,0,10
avail,0,0,4,4,0,2,10
spaceship,1,0,1,8,0,0,10
navy,4,0,1,3,2,0,10
attraction,1,0,3,2,3,1,10
counter,2,1,0,3,2,2,10
aftermath,3,1,1,2,3,0,10
cast,1,1,1,2,2,3,10
theory,2,1,0,5,1,1,10
press,0,0,0,4,5,1,10
photographer,2,3,1,0,1,3,10
curtain,1,0,5,0,0,4,10
stab,1,1,1,1,2,4,10
toy,3,0,2,5,0,0,10
patrol,2,0,0,2,5,1,10
jet,1,0,2,5,2,0,10
intervenes,0,0,1,3,5,1,10
route,2,1,0,0,5,2,10
phenomenon,0,1,1,4,2,2,10
quest,1,1,1,2,4,1,10
possibility,2,2,1,2,2,1,10
neighbour,1,1,3,1,1,3,10
doom,1,0,0,4,2,3,10
visitor,0,1,0,6,1,2,10
trick,2,1,2,1,0,4,10
great,2,2,2,1,2,1,10
devil,1,0,1,2,1,5,10
cemetery,2,0,0,1,2,5,10
singh,2,0,3,0,5,0,10
objection,3,0,3,1,2,1,10
decade,3,1,2,2,1,1,10
stake,3,1,0,1,1,4,10
major,3,0,1,1,5,0,10
january,4,2,0,4,0,0,10
mass,2,1,1,3,2,1,10
proposal,1,1,4,0,4,0,10
comrade,1,1,0,1,6,1,10
territory,1,0,1,1,7,0,10
cannon,0,0,1,5,3,1,10
lair,0,0,1,4,1,4,10
assassin,3,0,0,1,6,0,10
valley,1,0,1,5,2,1,10
vengeance,0,0,1,0,7,2,10
departure,0,3,2,3,2,0,10
up,3,2,2,0,1,2,10
destiny,4,3,0,0,2,1,10
march,5,0,1,1,2,1,10
policeman,1,0,3,1,2,3,10
sailor,1,0,3,3,0,3,10
royal,2,1,3,1,3,0,10
frame,2,0,2,1,2,3,10
neighborhood,5,2,2,1,0,0,10
garden,2,0,2,5,1,0,10
access,2,0,1,2,2,3,10
headquarters,1,0,2,4,3,0,10
stranger,3,0,2,0,4,1,10
baron,1,0,0,3,1,5,10
fighting,0,0,1,2,6,1,10
emergency,0,0,2,4,2,2,10
meaning,2,1,5,1,1,0,10
shotgun,1,0,0,1,1,7,10
museum,0,2,0,5,0,3,10
happiness,4,0,4,1,1,0,10
involvement,5,2,0,1,2,0,10
burial,2,0,0,1,1,6,10
capture,3,0,0,4,2,1,10
direction,0,0,4,2,1,3,10
ruler,1,0,2,4,1,2,10
portal,0,0,1,3,0,6,10
magic,3,2,2,0,0,3,10
employer,1,2,1,2,2,2,10
mistress,4,0,1,0,1,4,10
discovery,1,2,1,4,0,2,10
riot,5,3,0,0,0,2,10
ceiling,2,1,0,2,1,4,10
meal,2,0,2,3,1,2,10
diamond,2,3,2,0,1,2,10
japanese,2,0,2,5,1,0,10
gunfight,3,0,1,0,5,1,10
north,1,0,4,2,2,1,10
rose,2,1,1,2,2,2,10
goon,2,1,1,1,5,0,10
entry,1,3,1,2,1,2,10
spite,3,1,1,2,2,1,10
competition,3,1,4,0,2,0,10
facility,1,1,1,5,1,1,10
trio,1,2,1,2,2,2,10
mumbai,1,1,6,0,2,0,10
cry,0,1,2,4,2,1,10
champion,1,1,2,2,3,1,10
tape,0,1,1,1,2,5,10
evil,1,1,0,1,2,5,10
departs,1,0,2,3,0,4,10
skeleton,1,0,1,2,1,5,10
shoot,3,1,1,0,4,1,10
error,0,0,7,2,1,0,10
advisor,3,2,2,0,1,1,9
article,3,0,0,1,3,2,9
hostage,2,1,1,1,2,2,9
secretary,4,2,1,1,0,1,9
absence,1,1,0,1,3,3,9
motif,4,0,0,3,1,1,9
tiger,4,0,3,0,2,0,9
elevator,5,1,0,0,0,3,9
cash,4,1,1,0,2,1,9
instance,2,1,2,2,0,2,9
ammunition,0,0,1,1,5,2,9
council,1,1,1,2,3,1,9
talk,1,2,2,0,1,3,9
laughter,2,0,4,1,1,1,9
horseback,0,1,0,1,4,3,9
opera,1,0,3,0,1,4,9
protest,1,0,5,2,1,0,9
hit,3,2,3,0,1,0,9
reflection,0,0,1,0,1,7,9
sam,2,1,0,2,2,2,9
joseph,2,3,1,1,0,2,9
mouse,3,0,3,1,2,0,9
niece,0,2,1,1,4,1,9
von,2,1,1,1,1,3,9
stay,0,3,0,0,0,6,9
volunteer,3,1,0,1,4,0,9
universe,0,2,0,6,0,1,9
emperor,3,0,1,2,3,0,9
railroad,0,0,0,2,7,0,9
fit,3,0,1,1,1,3,9
orbit,1,0,1,7,0,0,9
blast,2,0,0,6,0,1,9
blade,4,0,0,0,3,2,9
ward,3,0,0,1,0,5,9
deed,1,0,2,1,4,1,9
charlie,2,0,1,2,1,3,9
stick,1,1,1,2,1,3,9
wire,2,0,2,2,2,1,9
doc,0,0,1,4,2,2,9
flying,0,0,5,1,2,1,9
debt,3,2,2,1,0,1,9
squadron,2,0,1,2,3,1,9
san,1,0,0,5,1,2,9
kidnapping,2,0,1,2,2,2,9
throne,2,0,4,1,2,0,9
texas,1,0,0,0,6,2,9
justice,3,0,2,0,3,1,9
lead,1,1,1,1,1,4,9
hell,0,0,0,0,1,8,9
posse,0,0,0,0,7,2,9
address,3,0,2,1,2,1,9
jewish,6,1,1,0,1,0,9
tribe,1,2,0,1,4,1,9
ad,2,0,2,1,1,3,9
d,2,0,0,1,3,3,9
status,3,1,1,1,2,1,9
cliff,1,0,2,0,4,2,9
arranges,1,1,2,3,2,0,9
episode,1,1,2,5,0,0,9
august,4,3,1,1,0,0,9
midst,1,0,1,3,3,1,9
dan,3,2,0,2,1,1,9
detective,2,0,2,0,1,4,9
curiosity,1,0,1,2,2,3,9
fund,3,0,3,1,2,0,9
fort,2,2,0,0,3,2,9
havoc,1,0,0,5,1,2,9
teenager,0,2,1,2,1,3,9
muslim,2,4,3,0,0,0,9
fleet,1,0,1,3,3,1,9
winner,1,0,2,3,3,0,9
residence,1,0,3,1,0,4,9
x,2,1,0,2,2,2,9
conclusion,2,1,3,0,2,1,9
singing,2,0,4,0,1,2,9
civil,2,1,0,0,5,1,9
nation,4,1,3,1,0,0,9
suspect,3,0,2,0,2,2,9
christian,0,2,2,1,2,2,9
trust,0,0,4,1,3,1,9
option,1,0,3,1,4,0,9
mile,1,1,0,4,2,1,9
nazis,2,1,1,0,3,2,9
brown,1,0,3,3,1,1,9
governor,2,0,0,2,4,1,9
individual,1,1,2,2,2,1,9
bite,0,0,0,0,1,8,9
fashion,2,1,1,1,1,3,9
invitation,2,0,2,2,0,3,9
townspeople,2,0,0,2,2,3,9
quarter,3,0,0,2,2,2,9
los angeles,4,0,0,0,3,2,9
alarm,2,0,0,2,2,3,9
surgery,0,1,2,1,1,4,9
pocket,1,0,2,1,3,2,9
culture,2,5,2,0,0,0,9
narrator,2,1,3,1,0,2,9
retirement,3,0,1,1,2,2,9
showdown,0,0,0,1,8,0,9
vacation,0,1,1,2,0,5,9
succumbs,1,0,2,1,4,1,9
villain,2,2,1,1,3,0,9
burst,1,0,0,6,0,2,9
filmmaker,0,6,2,0,0,1,9
helicopter,1,0,1,4,1,2,9
germans,5,0,0,0,4,0,9
civilization,1,0,1,3,2,2,9
assassination,3,0,1,0,4,1,9
collision,1,0,1,6,1,0,9
permission,0,1,3,1,2,2,9
arrow,0,0,1,2,5,1,9
alias,1,0,3,1,2,2,9
trauma,2,1,2,1,1,2,9
commissioner,3,0,0,0,6,0,9
bounty,2,0,0,3,4,0,9
angel,3,0,1,0,3,2,9
exit,4,0,0,1,1,3,9
bandit,0,0,0,2,7,0,9
development,5,2,0,1,1,0,9
wreck,1,0,0,5,2,0,8
courage,1,1,4,1,1,0,8
tokyo,1,0,0,4,2,1,8
cabin,0,1,0,1,3,3,8
joe,2,1,1,1,1,2,8
custom,3,0,1,0,3,1,8
graveyard,1,0,1,0,2,4,8
inability,2,0,4,1,1,0,8
clue,3,1,0,1,0,3,8
proof,1,0,0,3,1,3,8
sweetheart,0,0,1,1,3,3,8
stand,3,1,0,2,1,1,8
shaft,3,0,0,3,1,1,8
theme,1,2,2,2,0,1,8
shoulder,1,0,0,1,3,3,8
cook,1,0,3,1,2,1,8
june,4,0,0,2,0,2,8
performer,1,1,1,1,1,3,8
material,0,1,1,3,2,1,8
vijay,1,2,3,0,2,0,8
learns,2,0,3,1,1,1,8
education,1,5,1,0,1,0,8
producer,2,2,0,2,1,1,8
empire,2,1,1,2,1,1,8
ben,1,0,1,1,3,2,8
sand,0,0,1,2,3,2,8
october,2,1,0,4,0,1,8
first,1,1,0,2,4,0,8
example,3,2,0,1,1,1,8
p.,2,2,3,1,0,0,8
pacific,3,0,0,1,3,1,8
kiss,2,0,3,1,1,1,8
design,1,3,0,0,3,1,8
basis,1,2,2,0,2,1,8
anguish,0,0,4,2,1,1,8
tenant,2,3,1,1,1,0,8
harry,2,0,0,1,2,3,8
miss,1,0,2,1,2,2,8
insurance,5,0,1,0,1,1,8
follower,2,1,1,2,2,0,8
november,3,1,0,3,0,1,8
delivery,3,1,1,1,1,1,8
samurai,2,0,0,1,4,1,8
britain,1,2,1,1,2,1,8
poverty,1,0,5,0,2,0,8
reinforcement,0,0,0,1,7,0,8
reputation,1,1,1,2,2,1,8
academy,3,0,0,2,2,1,8
simon,1,1,0,0,4,2,8
motorcycle,1,0,0,2,2,3,8
bit,1,1,3,1,0,2,8
executive,3,1,1,2,1,0,8
prayer,2,0,2,1,0,3,8
september,4,0,0,3,1,0,8
buddy,2,0,0,1,4,1,8
california,1,0,0,5,1,1,8
april,2,1,3,0,2,0,8
lifestyle,5,0,1,0,1,1,8
chair,1,0,2,2,0,3,8
rat,1,0,2,1,2,2,8
convict,2,1,2,1,2,0,8
row,2,1,2,0,2,1,8
collector,3,1,0,0,1,3,8
fiction,1,0,0,6,1,0,8
sin,1,1,2,0,1,3,8
ranch,0,0,0,0,8,0,8
mid,2,0,3,1,0,2,8
cellar,0,0,0,1,0,7,8
advantage,3,1,0,2,1,1,8
doubt,1,3,0,2,1,1,8
fame,2,0,2,2,1,1,8
addition,2,0,2,2,1,1,8
coma,1,0,2,1,2,2,8
cure,1,0,2,3,0,2,8
fly,0,0,0,4,2,2,8
price,2,0,2,1,1,2,8
contract,1,2,1,2,2,0,8
patrick,2,0,0,4,0,2,8
colony,1,0,1,3,3,0,8
expedition,1,0,0,2,3,2,8
underworld,1,0,2,0,2,3,8
central,1,0,2,3,1,1,8
routine,3,1,1,1,2,0,8
scar,1,0,2,0,2,3,8
investigates,1,1,0,0,2,4,8
ed,1,1,1,2,0,3,8
genius,1,0,0,4,1,2,8
spacecraft,0,0,0,7,1,0,8
joke,2,0,2,1,1,2,8
suburb,0,1,2,2,1,2,8
blow,2,0,0,2,3,1,8
clutch,1,0,3,1,2,1,8
flag,1,1,1,2,3,0,8
outskirt,1,2,1,1,1,2,8
narrative,3,2,1,1,1,0,8
instruction,2,1,1,0,2,2,8
jungle,2,0,0,2,1,3,8
countryside,1,0,1,2,2,2,8
wheel,1,1,0,2,2,2,8
spear,2,0,1,2,2,1,8
feud,1,3,0,0,4,0,8
mechanism,1,0,0,6,0,1,8
majority,2,1,1,2,2,0,8
americans,3,2,0,0,2,1,8
tamil,2,1,2,0,3,0,8
axe,0,0,1,1,2,4,8
forgiveness,3,0,1,1,2,1,8
seat,4,1,1,1,1,0,8
dealer,5,1,0,0,2,0,8
spot,1,1,2,0,2,2,8
scenario,2,0,2,1,1,2,8
ss,4,1,0,1,2,0,8
structure,5,0,0,3,0,0,8
old,0,1,0,3,2,2,8
contrast,0,2,3,0,1,2,8
mine,1,0,1,0,6,0,8
drama,2,0,4,1,1,0,8
pig,0,3,1,1,1,2,8
sir,0,1,1,2,2,2,8
pirate,0,1,2,2,3,0,8
motel,3,0,2,1,0,2,8
color,3,0,1,2,1,1,8
iraq,0,4,1,0,1,2,8
pregnancy,2,1,2,1,1,1,8
technique,0,1,1,2,3,1,8
blessing,1,2,3,0,1,1,8
bench,0,2,3,0,2,1,8
inn,1,0,0,1,2,4,8
dust,0,1,1,4,0,2,8
purchase,0,1,1,2,3,1,8
personality,1,0,2,3,1,1,8
nose,0,1,1,3,2,1,8
generation,1,3,4,0,0,0,8
fbi,5,0,0,1,0,2,8
strength,0,1,1,3,1,2,8
classmate,0,1,2,1,1,3,8
out,2,1,0,1,3,1,8
traveler,0,3,0,3,1,1,8
opinion,3,1,0,2,0,2,8
editor,0,2,1,2,1,2,8
collapse,0,0,4,3,1,0,8
pursuer,2,0,0,1,3,2,8
degree,0,1,6,0,1,0,8
grandson,0,1,3,1,1,2,8
accusation,2,1,1,1,1,2,8
list,2,0,1,2,2,1,8
retreat,1,0,0,3,1,2,7
destruct,2,0,0,5,0,0,7
item,1,0,2,2,1,1,7
moments,2,0,0,3,1,1,7
fugitive,1,0,0,2,3,1,7
reaction,1,2,0,3,1,0,7
werewolf,0,0,1,0,0,6,7
wrist,1,0,1,1,1,3,7
suitor,2,0,2,1,1,1,7
inquiry,2,1,0,2,1,1,7
grenade,3,1,1,0,2,0,7
expense,1,0,2,3,1,0,7
italian,3,0,2,0,0,2,7
johnny,3,0,0,0,1,3,7
behalf,1,0,3,0,3,0,7
cowardice,1,0,2,0,3,1,7
host,0,1,1,3,0,2,7
supporter,0,2,2,0,2,1,7
disaster,1,1,2,3,0,0,7
pas,0,1,2,0,2,2,7
blame,1,1,1,1,1,2,7
assignment,2,2,1,2,0,0,7
wine,0,0,0,2,0,5,7
mdash,1,0,3,0,2,1,7
coach,0,0,2,1,2,2,7
bone,3,0,1,2,1,0,7
hollywood,0,1,2,1,2,1,7
fiancee,0,0,0,3,2,2,7
pit,0,1,1,0,1,4,7
confusion,1,1,1,1,0,3,7
ransom,1,2,1,0,3,0,7
tension,1,1,2,0,1,2,7
concept,1,1,3,2,0,0,7
bathroom,3,0,1,0,0,3,7
arthur,2,0,1,1,2,1,7
jackson,1,2,1,0,3,0,7
fortress,1,0,1,2,2,1,7
instinct,1,0,0,1,3,2,7
catholic,1,0,1,1,2,2,7
demise,2,0,2,1,1,1,7
afterlife,2,0,0,0,1,4,7
round,2,1,0,2,2,0,7
landing,2,0,0,3,1,1,7
arrangement,2,0,2,0,1,2,7
steel,2,0,0,0,4,1,7
summons,1,0,2,0,1,3,7
premise,0,1,2,1,2,1,7
uniform,1,0,3,0,3,0,7
occasion,2,0,2,1,2,0,7
orphan,1,2,1,1,1,1,7
hatch,0,1,1,2,1,2,7
telephone,2,0,2,1,0,2,7
independence,0,0,4,2,1,0,7
shadow,1,0,0,1,1,4,7
shirt,1,1,1,1,2,1,7
peasant,1,0,0,1,3,2,7
impact,0,1,1,5,0,0,7
length,1,0,1,1,2,2,7
ali,0,2,3,0,1,1,7
medicine,1,0,0,3,3,0,7
elizabeth,1,0,1,2,1,2,7
insistence,1,0,2,1,3,0,7
cigarette,3,0,2,0,0,2,7
loyalty,0,0,0,1,5,1,7
look,1,1,3,0,0,2,7
explanation,1,0,4,0,1,1,7
district,3,2,1,0,1,0,7
merchant,2,1,0,0,3,1,7
punjab,2,0,1,0,4,0,7
sharma,1,0,5,0,1,0,7
file,4,1,0,1,1,0,7
labor,2,0,1,0,3,1,7
session,1,1,0,3,0,2,7
studio,2,0,2,1,1,1,7
apparition,0,0,0,3,0,4,7
craft,0,0,0,5,1,1,7
conviction,2,2,1,1,1,0,7
skin,1,0,0,5,0,1,7
reception,2,0,0,2,1,2,7
environment,2,1,1,2,1,0,7
determination,1,2,3,1,0,0,7
mount,1,2,1,0,3,0,7
sheet,2,0,0,1,0,4,7
depth,2,1,0,3,0,1,7
display,1,0,2,1,1,2,7
ambulance,2,0,1,0,2,2,7
rank,0,0,0,3,3,1,7
monk,1,2,0,1,2,1,7
portion,0,1,4,2,0,0,7
meet,2,0,2,1,2,0,7
edward,1,1,1,1,2,1,7
league,1,0,1,1,3,1,7
document,0,0,3,0,2,2,7
deputy,2,0,0,1,4,0,7
mohan,1,2,2,0,2,0,7
dirt,1,0,0,3,2,1,7
surgeon,0,0,0,1,1,5,7
winter,1,2,0,0,3,1,7
rape,3,0,0,0,2,2,7
catch,1,0,3,2,0,1,7
inside,0,0,0,2,3,2,7
nightclub,4,1,0,1,0,1,7
taxi,1,0,2,2,1,1,7
compound,2,0,1,0,4,0,7
inspiration,0,2,1,2,0,2,7
balcony,3,0,1,0,0,3,7
peer,1,0,1,2,0,3,7
revelation,2,0,0,3,0,2,7
solace,0,1,2,1,1,2,7
entity,0,1,1,2,0,3,7
discussion,2,1,2,1,0,1,7
commission,2,0,1,1,3,0,7
rent,2,1,3,1,0,0,7
saint,1,2,3,0,0,1,7
understanding,1,1,0,2,3,0,7
rebellion,1,1,0,1,4,0,7
rail,0,1,1,3,2,0,7
collection,1,1,1,1,0,3,7
crystal,0,2,1,3,0,1,7
broadcast,0,0,0,5,0,2,7
fishing,1,0,1,4,1,0,7
hans,2,0,2,2,0,1,7
institute,0,0,3,4,0,0,7
martin,1,1,0,1,2,2,7
frankenstein,0,0,0,2,0,5,7
juncture,1,0,2,1,3,0,7
reunites,0,0,3,2,1,1,7
tommy,4,0,0,2,1,0,7
weight,0,1,1,1,1,3,7
motion,0,1,0,4,2,0,7
confidence,1,0,3,1,2,0,7
humiliation,1,0,3,0,3,0,7
attic,2,0,2,1,0,2,7
forehead,2,0,1,1,2,1,7
piano,2,0,0,1,0,4,7
dagger,0,0,0,1,0,6,7
review,1,1,1,2,0,2,7
shoe,2,0,2,0,1,2,7
vain,2,1,1,1,0,2,7
demonstration,2,1,1,3,0,0,7
fence,1,0,1,2,1,2,7
comfort,0,0,2,1,2,2,7
coffee,2,1,1,1,2,0,7
lt,4,0,0,0,3,0,7
crown,1,2,1,0,3,0,7
desk,3,1,1,0,0,2,7
i,1,1,1,2,0,2,7
goal,0,1,1,2,3,0,7
j.,1,0,2,1,3,0,7
consciousness,0,0,2,1,1,3,7
descendant,1,2,0,2,0,2,7
delhi,2,0,4,0,1,0,7
garbage,1,2,2,0,0,2,7
ram,1,1,4,1,0,0,7
alcoholic,0,0,1,2,2,2,7
mark,1,1,0,3,0,2,7
shootout,1,0,0,1,4,1,7
pile,2,0,0,3,1,1,7
misery,3,0,2,0,0,2,7
ambush,1,0,0,1,4,1,7
tragedy,3,0,1,1,1,1,7
region,1,1,2,0,3,0,7
tie,2,0,1,1,2,1,7
today,2,4,1,0,0,0,7
wagon,1,0,0,3,3,0,7
leave,0,0,3,0,4,0,7
symbol,2,0,2,1,2,0,7
duo,0,0,2,4,1,0,7
chinese,3,1,0,1,2,0,7
bruce,2,0,2,1,2,0,7
theft,1,0,1,2,2,1,7
bully,0,0,1,2,1,3,7
spanish,0,0,2,1,3,1,7
tycoon,1,0,1,0,4,1,7
impression,1,1,1,0,2,2,7
hat,1,0,3,1,1,1,7
millionaire,2,0,2,0,0,3,7
missile,1,0,1,5,0,0,7
herd,0,0,1,2,4,0,7
triumph,0,0,4,1,1,1,7
feature,2,0,2,1,2,0,7
stair,1,0,0,3,0,3,7
pleasure,1,0,2,1,2,1,7
dozen,2,0,1,1,2,1,7
block,2,1,0,3,1,0,7
bush,1,1,2,2,1,0,7
quality,2,2,2,1,0,0,7
florida,2,1,1,0,0,3,7
fruit,3,1,2,1,0,0,7
portrait,0,2,1,0,2,2,7
sub,4,1,0,1,0,1,7
johnson,2,1,0,1,2,1,7
charm,1,1,0,1,1,3,7
flash,0,0,2,3,1,1,7
pack,1,1,3,1,0,1,7
stroke,0,1,2,0,1,2,6
cowboy,1,0,3,0,1,1,6
sadness,2,0,3,1,0,0,6
heel,2,0,3,0,0,1,6
boxing,3,0,0,1,2,0,6
stomach,2,0,0,1,2,1,6
carriage,1,0,1,0,1,3,6
candy,2,1,0,1,1,1,6
passion,3,0,2,0,0,1,6
pay,2,0,2,0,2,0,6
legend,1,0,0,2,2,1,6
victor,1,1,0,2,0,2,6
hideout,2,1,1,1,1,0,6
retribution,1,0,0,0,5,0,6
rumor,2,0,0,2,1,1,6
feat,0,1,0,4,0,1,6
physician,2,0,0,1,1,2,6
fool,1,0,2,0,2,1,6
undead,0,0,0,0,0,6,6
swordsman,1,0,0,0,4,1,6
reference,1,1,1,3,0,0,6
fiancée,1,1,0,1,2,1,6
squad,5,0,0,0,0,1,6
copy,3,0,0,2,0,1,6
poison,0,0,2,1,2,1,6
proceeds,2,2,1,0,1,0,6
bravery,2,1,0,0,3,0,6
harassment,0,2,1,0,3,0,6
policy,3,1,1,0,1,0,6
maid,0,0,0,1,1,4,6
gorge,1,0,2,0,1,2,6
danny,1,0,0,0,4,1,6
amusement,0,1,3,1,0,1,6
cinema,2,1,1,1,0,1,6
concentration,3,0,1,0,1,1,6
rush,0,0,1,1,2,2,6
horde,0,0,0,2,1,3,6
burn,0,0,2,2,0,2,6
bow,0,0,0,2,4,0,6
mood,1,0,0,2,2,1,6
prime,1,1,0,2,1,1,6
cavalry,0,0,0,1,5,0,6
cathedral,0,0,1,1,2,2,6
pleads,2,0,1,1,1,1,6
shovel,0,0,0,1,1,4,6
galaxy,0,2,0,4,0,0,6
thunderstorm,1,0,3,1,0,1,6
gunfire,0,0,0,3,1,2,6
kidnaps,0,0,1,3,1,1,6
internet,0,1,2,2,1,0,6
regret,0,1,2,1,1,1,6
vietnam,2,1,1,0,0,2,6
sunrise,0,0,0,2,1,3,6
chicago,3,0,1,1,1,0,6
oil,1,1,2,1,1,0,6
bet,1,0,1,2,2,0,6
terror,1,0,0,1,2,2,6
treason,0,0,0,1,5,0,6
rag,2,0,3,1,0,0,6
sewer,1,0,1,2,0,2,6
rivalry,3,1,1,1,0,0,6
aide,4,0,0,1,1,0,6
maria,2,0,1,3,0,0,6
terrorist,1,0,1,2,2,0,6
psychiatrist,2,0,0,2,0,2,6
francisco,1,0,0,4,1,0,6
insult,4,0,1,0,1,0,6
gunshot,0,1,0,1,2,2,6
scuffle,0,1,2,0,2,1,6
establishment,2,0,2,0,2,0,6
type,1,0,3,1,0,1,6
finding,1,0,0,1,0,4,6
bottom,1,0,1,1,1,2,6
virgin,1,0,2,0,0,3,6
industry,4,0,0,1,1,0,6
enterprise,3,0,0,3,0,0,6
favour,0,0,1,2,2,1,6
depression,2,0,3,0,0,1,6
grandparent,1,1,1,1,1,1,6
venture,1,0,1,1,1,2,6
bodyguard,1,0,1,1,3,0,6
united states,3,1,1,0,1,0,6
dragon,1,0,3,2,0,0,6
plate,1,0,1,3,1,0,6
profession,0,0,2,0,2,2,6
agency,2,0,2,1,1,0,6
desperation,2,0,2,0,0,2,6
pity,3,0,0,1,1,1,6
dracula,0,0,0,0,0,6,6
big,0,2,2,1,1,0,6
retaliation,2,0,2,0,2,0,6
trance,0,0,2,1,0,3,6
notice,2,1,1,1,0,1,6
necklace,0,0,2,0,1,3,6
vote,1,1,1,0,3,0,6
storage,1,0,2,1,0,2,6
opponent,0,1,1,1,3,0,6
wayne,3,0,0,2,0,1,6
dollar,1,0,1,1,3,0,6
bob,2,0,0,2,2,0,6
testimony,2,2,0,1,0,1,6
tear,0,0,2,2,1,1,6
cage,1,1,0,1,0,3,6
july,1,1,0,2,1,1,6
goddess,0,0,4,0,1,1,6
occupation,1,1,3,1,0,0,6
page,0,0,1,2,0,3,6
entertainment,1,0,1,1,1,2,6
roman,3,0,1,0,1,1,6
captor,1,0,1,3,1,0,6
politics,2,1,1,0,2,0,6
procession,2,0,0,0,1,3,6
obsession,2,0,1,1,0,2,6
core,1,1,0,3,1,0,6
silence,2,0,0,3,1,0,6
stepmother,4,1,0,0,0,1,6
measure,0,0,3,0,1,2,6
alliance,1,0,0,0,4,1,6
prasad,1,1,3,0,1,0,6
size,0,1,1,3,0,1,6
lee,1,0,1,0,3,1,6
cycle,0,1,2,1,1,1,6
lock,0,1,0,2,1,2,6
content,1,0,0,3,0,2,6
chennai,1,2,1,0,2,0,6
prof.,0,1,1,1,0,3,6
skirmish,1,0,1,1,2,1,6
mystery,2,0,0,1,2,1,6
plight,1,3,1,0,1,0,6
helen,1,0,0,0,1,4,6
mobster,4,1,1,0,0,0,6
survival,0,0,1,0,3,2,6
limit,1,0,0,0,4,1,6
fiancé,0,1,1,1,2,1,6
market,2,0,1,1,2,0,6
hindu,3,3,0,0,0,0,6
revolver,2,0,0,2,1,1,6
consent,1,1,2,1,0,1,6
attachment,1,1,1,1,1,1,6
author,2,2,0,2,0,0,6
refusal,0,0,3,1,2,0,6
guru,2,1,3,0,0,0,6
coffin,0,0,0,0,0,6,6
snake,0,1,2,1,1,1,6
dock,1,1,1,0,0,3,6
dean,1,1,1,2,0,1,6
spain,1,0,0,1,2,2,6
cattle,0,0,0,0,6,0,6
anniversary,0,0,1,1,1,3,6
aim,0,0,2,0,3,1,6
ego,1,0,3,1,1,0,6
torso,1,0,0,1,1,3,6
rod,0,0,1,1,2,2,6
kumar,0,3,1,0,2,0,6
cop,3,0,0,0,2,1,6
alfred,3,1,0,0,1,1,6
landscape,2,1,0,3,0,0,6
painting,0,1,2,2,0,1,6
bedside,1,1,0,3,1,0,6
coin,2,0,1,0,3,0,6
civilian,0,2,0,3,1,0,6
network,1,1,1,2,1,0,6
zone,1,0,0,4,1,0,6
liquor,2,0,0,0,2,2,6
commotion,1,0,1,0,1,3,6
surrender,2,0,0,3,1,0,6
wait,2,0,0,1,1,2,6
alan,2,0,1,1,0,2,6
confederate,1,0,0,0,5,0,6
rite,1,2,2,0,0,1,6
toilet,2,0,1,1,1,1,6
candle,1,1,1,1,0,2,6
esteem,2,0,3,1,0,0,6
stadium,0,0,1,3,2,0,6
africa,1,0,2,0,2,1,6
cake,1,0,1,1,2,1,6
farewell,2,0,2,2,0,0,6
duck,1,0,3,1,1,0,6
harm,1,1,0,1,1,2,6
jews,2,1,2,0,1,0,6
warden,2,1,1,1,0,1,6
guidance,1,0,0,1,2,2,6
compassion,1,0,2,0,1,2,6
method,0,0,3,0,2,1,6
f.,3,0,0,2,0,1,6
mankind,0,0,0,4,0,2,6
times,3,1,0,2,0,0,6
bay,0,0,0,4,1,1,6
kidnapper,2,0,1,1,2,0,6
airplane,1,0,2,0,2,1,6
deception,1,0,2,2,0,1,6
constable,0,0,0,0,6,0,6
distraught,2,0,0,1,2,1,6
atom,0,0,0,5,0,1,6
southern,0,0,0,2,4,0,6
derelict,2,0,1,1,1,1,6
karl,1,0,3,0,0,2,6
deck,0,0,0,4,2,0,6
wild,1,0,0,2,3,0,6
boarding,1,0,2,2,1,0,6
glove,2,0,1,0,2,1,6
library,1,1,1,2,1,0,6
arena,2,0,0,3,1,0,6
ambassador,1,0,0,1,2,2,6
cancer,2,1,0,2,0,1,6
organization,2,2,0,1,1,0,6
cold,1,1,2,0,2,0,6
pride,2,0,2,0,2,0,6
comedy,1,0,4,0,1,0,6
robber,2,1,0,0,2,1,6
principal,0,0,5,0,0,1,6
shark,2,0,2,2,0,0,6
capital,1,1,1,1,2,0,6
steve,1,1,0,2,1,1,6
cocaine,5,0,0,0,0,1,6
acid,0,0,0,2,0,4,6
brothel,3,0,0,0,2,1,6
pub,0,1,0,1,2,2,6
norman,1,0,0,0,2,3,6
jenny,1,0,1,2,1,1,6
sail,0,0,2,0,3,1,6
jim,3,2,0,1,0,0,6
barbara,1,0,0,1,0,4,6
mall,2,0,1,1,1,1,6
gambler,1,0,1,1,3,0,6
sri,1,3,2,0,0,0,6
medal,3,1,0,0,2,0,6
winston,4,1,0,1,0,0,6
sickness,4,0,0,2,0,0,6
resemblance,1,0,0,0,3,2,6
pan,1,1,2,1,0,1,6
relation,0,2,2,1,1,0,6
lie,0,0,3,1,1,1,6
fox,3,0,0,2,1,0,6
coat,1,1,0,1,2,1,6
special,3,0,1,1,1,0,6
bicycle,0,0,2,2,2,0,6
nest,2,0,1,1,2,0,6
motive,2,0,0,2,2,0,6
agony,0,2,0,2,0,2,6
prize,1,1,1,1,1,1,6
clerk,2,0,3,0,0,1,6
italy,3,1,0,1,0,1,6
lucy,0,0,0,0,2,4,6
extent,0,2,3,0,1,0,6
growth,0,1,0,2,1,2,6
bail,2,0,3,0,1,0,6
linda,0,0,1,3,0,2,6
krishna,1,2,1,0,2,0,6
crate,1,0,1,0,1,3,6
representative,2,0,2,1,1,0,6
script,2,0,0,2,0,2,6
wanders,0,0,1,2,1,2,6
twist,1,2,1,0,2,0,6
courtyard,2,2,0,0,1,1,6
cult,0,0,0,1,1,3,5
dedication,2,1,1,1,0,0,5
function,1,2,0,1,1,0,5
sorrow,0,0,0,2,2,1,5
chef,2,0,2,0,0,1,5
promotion,2,0,1,1,1,0,5
prank,1,0,2,2,0,0,5
link,0,1,0,1,2,1,5
raju,1,1,1,0,2,0,5
literature,3,1,1,0,0,0,5
dialogue,2,1,1,0,1,0,5
loot,2,0,0,1,2,0,5
heist,4,0,1,0,0,0,5
senator,3,0,0,0,2,0,5
anna,1,0,0,1,0,3,5
tombstone,0,0,0,1,2,2,5
liking,0,0,2,0,3,0,5
heroin,4,1,0,0,0,0,5
anand,0,2,2,0,1,0,5
e.,1,0,2,0,2,0,5
footstep,0,1,0,2,0,2,5
jeep,0,0,2,0,2,1,5
shooting,2,1,0,0,1,1,5
heaven,0,0,2,0,0,3,5
repair,2,0,1,2,0,0,5
payment,3,0,1,0,1,0,5
monologue,1,0,1,3,0,0,5
signature,0,0,1,3,0,1,5
marine,3,0,0,1,1,0,5
insanity,1,0,2,0,0,2,5
crewman,1,0,0,3,1,0,5
crisis,1,0,2,1,0,1,5
albert,2,0,0,1,0,2,5
outpost,1,0,0,1,1,2,5
range,1,1,0,2,1,0,5
propaganda,2,2,0,1,0,0,5
phantom,0,0,0,3,0,2,5
profit,1,2,0,0,2,0,5
padma,1,1,3,0,0,0,5
parade,2,0,0,1,2,0,5
electricity,2,0,1,2,0,0,5
claw,0,0,2,0,1,2,5
communist,2,1,2,0,0,0,5
mayor,2,0,0,1,0,2,5
breakdown,2,0,0,3,0,0,5
ramana,2,0,1,0,2,0,5
trunk,2,0,0,0,0,3,5
staircase,0,0,0,0,1,4,5
raj,2,1,1,1,0,0,5
morality,0,1,1,2,1,0,5
jesus,0,1,1,1,1,1,5
slum,2,1,1,1,0,0,5
tax,1,1,1,0,2,0,5
relents,2,1,1,0,1,0,5
apprentice,0,0,0,0,1,4,5
port,0,0,0,0,5,0,5
thirst,1,0,0,0,2,2,5
fantasy,2,0,0,1,0,2,5
pipe,1,1,1,1,1,0,5
politician,3,1,1,0,0,0,5
seed,1,1,1,2,0,0,5
the american civil war,0,0,0,0,5,0,5
popularity,3,0,1,1,0,0,5
things,0,1,1,0,2,1,5
marshal,0,0,0,0,4,1,5
occupant,1,0,1,2,0,1,5
raft,0,1,0,1,2,1,5
diner,2,0,1,2,0,0,5
ordeal,0,0,1,0,2,2,5
remnant,1,0,0,1,2,1,5
recovery,2,0,2,1,0,0,5
infection,1,0,0,0,1,3,5
brawl,0,0,0,1,4,0,5
massachusetts,1,1,0,0,1,2,5
imperial,2,0,2,0,1,0,5
fellow,0,1,1,0,2,1,5
clinic,2,0,0,1,0,2,5
getaway,2,0,0,2,1,0,5
rice,1,1,0,0,3,0,5
jimmy,4,0,0,0,0,1,5
murray,1,0,0,1,1,2,5
parting,2,1,0,1,1,0,5
alcohol,3,0,1,0,0,1,5
shower,1,0,2,1,0,1,5
sake,2,0,1,0,2,0,5
marty,1,0,0,3,0,1,5
little,3,0,0,0,1,1,5
swimming,0,1,2,0,0,2,5
fireplace,0,0,1,0,1,3,5
december,2,0,0,2,1,0,5
café,3,0,1,1,0,0,5
seth,1,0,1,1,0,2,5
gambling,1,0,2,0,1,1,5
auction,2,0,1,0,1,1,5
carl,2,1,0,1,0,1,5
dentist,2,0,1,1,1,0,5
pop,1,1,1,2,0,0,5
disgust,0,0,1,0,3,1,5
stepfather,0,0,0,0,1,4,5
summer,2,1,0,0,0,2,5
doll,0,0,1,0,1,3,5
monkey,0,0,3,1,0,1,5
plague,0,0,0,0,2,3,5
caretaker,2,1,0,0,0,2,5
frog,0,0,1,1,1,2,5
election,2,0,1,0,1,1,5
uprising,1,1,1,0,1,1,5
confinement,3,0,0,0,1,1,5
gordon,3,0,0,2,0,0,5
skull,0,0,0,2,0,3,5
hammer,1,0,1,0,0,3,5
voyage,0,0,0,3,2,0,5
twin,1,0,2,2,0,0,5
cabinet,2,1,1,1,0,0,5
bernard,1,0,0,2,2,0,5
siege,0,0,0,1,3,1,5
gesture,0,0,1,1,1,2,5
informant,4,0,1,0,0,0,5
enters,2,0,0,0,1,2,5
theatre,2,0,1,1,1,0,5
insight,1,0,0,1,2,1,5
tennessee,1,1,0,0,2,1,5
rabbit,1,0,3,0,1,0,5
bureau,3,0,0,0,1,1,5
draw,0,0,0,1,4,0,5
awe,0,0,1,2,1,1,5
pennsylvania,1,2,1,0,0,1,5
hometown,2,0,0,2,0,1,5
admiral,1,0,1,3,0,0,5
pet,0,1,1,2,0,1,5
breath,2,0,0,1,0,2,5
announcement,1,0,3,1,0,0,5
maya,0,2,1,1,1,0,5
bell,2,0,0,3,0,0,5
iii,0,0,3,2,0,0,5
silver,0,0,0,3,1,1,5
essence,0,1,0,1,1,2,5
outbreak,1,1,0,0,1,2,5
client,0,1,0,3,0,1,5
lion,0,1,2,2,0,0,5
australian,0,0,1,1,2,1,5
african,2,0,0,0,0,3,5
archaeologist,0,0,1,1,0,3,5
mill,1,0,1,1,1,1,5
shopping,2,0,0,2,0,1,5
chuck,0,0,0,1,2,2,5
gulf,0,3,1,1,0,0,5
text,0,2,1,0,2,0,5
perpetrator,0,1,0,1,0,3,5
exile,0,2,0,3,0,0,5
begs,2,0,1,0,0,2,5
topic,0,2,1,1,0,1,5
jewel,0,0,3,1,1,0,5
sample,1,0,0,3,1,0,5
hut,0,0,1,0,3,1,5
venue,2,0,0,1,2,0,5
lunch,1,1,1,1,1,0,5
strip,1,0,0,2,0,2,5
package,2,0,0,2,1,0,5
kelly,2,1,0,1,1,0,5
honeymoon,0,1,2,0,0,2,5
falls,3,0,0,1,0,1,5
afternoon,0,1,1,2,1,0,5
con,2,0,0,0,1,2,5
cache,2,0,0,0,3,0,5
frustration,3,0,1,0,0,1,5
bailey,2,1,0,1,0,1,5
may,2,0,0,2,1,0,5
carnage,1,0,0,0,1,3,5
forces,1,1,0,3,0,0,5
journal,0,0,0,3,2,0,5
clock,0,1,0,1,0,3,5
kindness,1,0,3,0,0,1,5
ticket,0,1,0,1,3,0,5
circus,0,1,2,0,0,2,5
fountain,0,0,1,1,1,2,5
transylvania,0,0,0,1,0,4,5
contrary,2,0,0,1,2,0,5
institution,3,0,1,0,0,1,5
usa,0,0,2,1,2,0,5
epiphany,1,0,2,1,1,0,5
passport,1,0,2,0,2,0,5
uss,0,0,0,5,0,0,5
narration,0,2,1,1,0,1,5
hari,1,1,2,1,0,0,5
fisherman,3,0,1,0,1,0,5
risk,1,0,1,0,3,0,5
jacket,0,0,1,1,2,1,5
clothing,0,0,1,1,3,0,5
pass,0,0,0,1,4,0,5
sugar,0,0,2,1,1,1,5
specialist,0,0,1,2,1,1,5
sanity,1,0,1,0,2,1,5
chandra,0,3,1,0,1,0,5
%,0,1,1,2,0,1,5
database,0,1,1,2,1,0,5
operator,1,0,0,2,2,0,5
spider,0,0,1,2,1,1,5
tavern,1,0,1,0,0,3,5
surname,0,0,0,3,2,0,5
vest,2,0,0,2,1,0,5
calm,0,0,1,2,1,1,5
detachment,0,0,0,1,4,0,5
telugu,1,1,3,0,0,0,5
the u.s. army,1,0,0,3,1,0,5
al,4,1,0,0,0,0,5
sunset,0,1,1,1,1,1,5
ancestor,1,1,0,2,0,1,5
fury,0,1,2,1,1,0,5
intent,0,0,2,1,1,1,5
embrace,1,0,0,1,0,3,5
revolution,1,0,1,0,3,0,5
wilson,0,1,0,0,3,1,5
scandal,1,1,1,1,0,1,5
shipment,1,0,0,0,3,1,5
taunt,1,0,1,0,0,3,5
long,1,0,1,1,1,1,5
medication,2,0,1,0,0,2,5
rich,0,1,2,1,0,1,5
dismay,0,0,2,1,1,1,5
tendency,1,1,0,2,1,0,5
celebrity,1,1,0,3,0,0,5
a,1,0,2,1,1,0,5
insect,0,0,0,2,0,3,5
indians,0,0,1,1,3,0,5
maiden,0,0,1,1,0,3,5
ghetto,2,2,1,0,0,0,5
cargo,1,0,0,2,2,0,5
virus,1,1,0,1,0,2,5
stanley,0,0,0,3,0,2,5
dressing,2,0,2,0,0,1,5
activist,0,2,2,0,1,0,5
conscience,0,2,1,2,0,0,5
balance,0,1,2,0,1,1,5
massacre,2,0,1,0,2,0,5
transplant,1,0,0,0,1,3,5
worth,1,0,0,0,4,0,5
occurrence,0,1,1,2,0,1,5
benefit,1,1,2,0,0,1,5
reading,0,0,3,0,0,2,5
ballet,0,0,2,0,0,3,5
concert,0,0,3,1,1,0,5
dr,0,1,0,1,1,2,5
formula,0,1,0,3,1,0,5
guardian,0,1,2,2,0,0,5
worry,1,0,2,0,1,1,5
license,3,0,0,0,2,0,5
cheek,2,0,2,0,0,1,5
giant,0,0,2,3,0,0,5
correspondent,1,1,0,0,3,0,5
complies,0,0,1,0,4,0,5
nemesis,0,0,1,1,3,0,5
wilderness,2,0,1,0,2,0,5
halloween,1,0,0,2,0,2,5
amulet,0,0,1,1,0,3,5
parker,0,0,1,3,0,1,5
grass,0,0,1,1,2,1,5
final,1,1,1,0,2,0,5
scout,2,1,0,1,1,0,5
wars,0,0,1,2,2,0,5
regime,2,1,2,0,0,0,5
dining,0,1,3,0,1,0,5
disciple,1,0,1,1,2,0,5
rally,2,0,1,1,1,0,5
product,1,1,0,2,0,1,5
string,0,0,3,2,0,0,5
baseball,1,1,0,0,1,2,5
jennifer,0,0,0,4,0,1,5
realm,1,0,1,1,0,2,5
cream,0,0,1,1,2,1,5
behaviour,1,1,2,1,0,0,5
guerrilla,0,1,0,1,3,0,5
preparation,0,1,1,2,1,0,5
transmission,0,0,0,4,0,1,5
million,1,1,1,1,1,0,5
religion,0,1,2,1,1,0,5
architect,1,0,1,1,0,2,5
smith,1,0,1,1,1,1,5
glory,1,0,2,0,2,0,5
pill,2,0,1,1,0,1,5
instrument,1,0,0,1,2,1,5
hobby,0,1,1,0,0,3,5
championship,0,0,2,0,3,0,5
international,2,1,1,0,1,0,5
stream,0,0,1,3,1,0,5
debut,1,2,0,1,0,1,5
tradition,0,4,0,0,1,0,5
montgomery,0,0,0,2,1,2,5
prophecy,0,0,0,2,1,2,5
era,1,1,0,2,0,1,5
division,4,0,0,0,1,0,5
caste,1,2,1,0,1,0,5
cameraman,2,0,0,0,1,2,5
nadu,1,1,0,0,3,0,5
aspect,1,1,1,2,0,0,5
sphere,0,1,1,3,0,0,5
labourer,3,1,1,0,0,0,5
realization,0,1,1,2,0,1,5
wit,1,0,3,0,1,0,5
imagination,0,2,1,2,0,0,5
parlor,1,1,0,0,1,2,5
harbor,1,0,1,0,2,1,5
sidekick,0,0,2,2,1,0,5
altercation,0,0,2,0,1,2,5
trailer,0,0,2,2,0,1,5
swing,1,0,3,0,0,1,5
drunkard,2,1,1,0,1,0,5
swamp,1,0,2,0,1,1,5
dislike,0,0,1,1,2,1,5
abraham,2,1,0,0,0,2,5
tail,0,0,3,1,0,1,5
golden,1,0,0,3,0,1,5
bunch,0,0,1,1,1,2,5
resource,1,1,0,1,2,0,5
casino,1,0,0,2,2,0,5
painter,0,0,4,0,0,1,5
allied,3,0,0,0,2,0,5
escort,2,0,0,0,3,0,5
montage,2,0,0,1,1,1,5
lakshmi,1,0,2,0,2,0,5
bribe,1,0,1,0,3,0,5
t.,1,0,0,2,2,0,5
principle,0,1,3,0,1,0,5
atrocity,1,1,2,0,0,1,5
ditch,1,0,0,2,1,1,5
pakistani,0,1,1,0,3,0,5
male,1,1,0,1,1,1,5
the soviet union,2,0,2,1,0,0,5
knight,0,1,0,1,1,2,5
communication,1,0,0,3,0,1,5
frederick,2,0,0,1,1,1,5
footprint,0,0,0,3,1,1,5
idol,1,0,3,1,0,0,5
kong,2,0,0,1,1,1,5
earthquake,0,2,1,1,0,1,5
treachery,2,0,1,0,2,0,5
fault,1,0,1,1,1,1,5
winning,1,0,1,3,0,0,5
ranger,2,0,2,0,0,1,5
surveillance,2,0,0,0,2,1,5
mentor,1,1,0,1,1,1,5
toll,2,0,0,1,2,0,5
distress,0,0,0,4,1,0,5
writing,0,0,2,1,0,2,5
convention,0,0,1,1,2,1,5
young,1,1,0,1,1,1,5
flirt,3,1,1,0,0,0,5
blue,1,1,0,1,1,1,5
description,0,1,2,0,1,1,5
telegram,3,0,0,0,1,1,5
kevin,2,1,1,0,0,0,4
cheat,1,1,2,0,0,0,4
trash,1,1,1,0,0,1,4
pune,1,2,0,0,1,0,4
cheer,1,0,1,0,2,0,4
toad,0,0,0,0,2,2,4
lust,0,1,0,1,0,2,4
cable,1,1,0,1,0,1,4
defence,0,1,2,0,1,0,4
clown,0,1,2,0,0,1,4
crumbles,0,1,0,0,1,2,4
tournament,1,0,0,1,2,0,4
antic,0,0,1,1,1,1,4
barrier,0,0,2,0,2,0,4
loneliness,0,0,2,1,1,0,4
calcutta,0,1,2,1,0,0,4
haste,0,1,0,3,0,0,4
perspective,1,1,1,1,0,0,4
boot,0,0,0,0,3,1,4
slaughter,0,0,0,0,4,0,4
jane,1,1,0,0,0,2,4
cart,0,0,0,0,4,0,4
australia,0,0,1,2,1,0,4
racket,1,0,2,0,0,1,4
extension,1,0,1,2,0,0,4
potato,0,0,3,1,0,0,4
teeth,0,0,1,1,1,1,4
surf,0,0,1,0,1,2,4
flesh,0,0,0,0,1,3,4
consort,0,0,2,0,0,2,4
turkey,1,1,0,1,1,0,4
saturday,1,1,0,1,1,0,4
ratna,0,1,3,0,0,0,4
learning,0,0,1,1,1,1,4
mike,0,0,1,2,0,1,4
casket,0,1,0,2,0,1,4
disposal,1,0,0,1,1,1,4
janitor,1,0,1,0,0,2,4
bid,0,1,0,0,3,0,4
hide,0,0,0,1,0,3,4
cow,0,0,1,0,2,1,4
gray,1,0,0,1,1,1,4
exposure,0,0,1,2,0,1,4
picnic,0,0,4,0,0,0,4
hurry,1,1,1,0,1,0,4
kidnap,0,1,0,2,1,0,4
deer,0,0,0,1,1,2,4
vault,0,0,1,1,1,1,4
roy,1,0,0,2,1,0,4
populace,0,0,1,2,1,0,4
mountains,0,2,0,1,0,1,4
voodoo,0,0,0,0,0,4,4
trainee,0,0,2,0,2,0,4
graf,0,0,0,0,0,4,4
rider,0,1,0,2,1,0,4
howl,0,0,1,1,1,1,4
sens,0,0,2,0,2,0,4
discover,0,0,1,0,1,2,4
compensation,1,1,1,1,0,0,4
trader,2,0,0,0,2,0,4
helmet,2,0,1,1,0,0,4
column,0,0,0,1,2,1,4
porch,0,0,1,3,0,0,4
brake,0,0,2,1,0,1,4
chorus,0,0,2,1,0,1,4
praise,2,0,2,0,0,0,4
daily,0,1,0,2,1,0,4
gentleman,1,0,1,0,1,1,4
neighbourhood,1,0,1,0,2,0,4
saikumar,0,1,0,0,2,1,4
nobleman,0,0,0,0,1,3,4
cooper,1,0,0,1,0,2,4
tip,2,0,1,0,1,0,4
runner,0,0,2,0,2,0,4
bureaucracy,1,0,0,1,1,1,4
stephen,1,0,0,0,0,3,4
sweeney,1,1,0,0,1,1,4
shame,0,0,1,2,1,0,4
airship,1,0,1,2,0,0,4
burglar,3,0,0,0,0,1,4
advocate,1,0,1,0,2,0,4
carnival,1,0,1,2,0,0,4
nair,1,1,1,0,1,0,4
nino,1,0,1,0,2,0,4
longs,0,2,1,0,1,0,4
persona,0,0,1,2,1,0,4
temptation,1,0,0,1,0,2,4
chaplin,2,0,2,0,0,0,4
offering,0,0,1,0,3,0,4
distraction,1,0,0,3,0,0,4
mrs,0,1,1,0,1,1,4
alley,0,0,1,1,1,1,4
louis,0,1,1,1,1,0,4
circuit,0,0,1,2,0,1,4
menace,1,0,0,1,1,1,4
roger,1,0,0,0,2,1,4
bloom,0,0,3,0,1,0,4
gap,0,0,2,0,2,0,4
paradise,2,0,0,1,1,0,4
jealousy,1,0,1,0,1,1,4
turning,1,1,1,1,0,0,4
larry,0,0,1,1,1,1,4
rate,2,0,1,0,1,0,4
granddaughter,0,0,0,0,2,2,4
|,0,1,0,1,1,1,4
watchman,1,0,2,1,0,0,4
hours,0,1,0,0,1,2,4
contingent,1,0,0,1,1,1,4
incantation,0,0,0,0,0,4,4
intimidation,1,1,0,0,2,0,4
tire,1,1,0,0,0,2,4
rao,0,1,3,0,0,0,4
slavery,2,0,0,0,2,0,4
find,0,0,2,1,0,1,4
sultan,0,1,2,1,0,0,4
senior,1,0,1,0,2,0,4
fred,0,1,0,2,0,1,4
allegiance,0,0,1,0,3,0,4
jazz,0,0,2,2,0,0,4
try,1,0,0,1,1,1,4
stagecoach,0,0,0,0,3,1,4
drain,0,0,1,2,1,0,4
nut,1,0,1,1,0,1,4
hanging,1,0,0,0,1,2,4
kerala,0,2,0,0,2,0,4
plantation,1,1,0,0,0,2,4
flock,0,1,2,1,0,0,4
varma,0,1,1,0,2,0,4
poker,1,0,1,0,1,1,4
spree,0,0,0,0,1,3,4
raymond,0,0,1,2,0,1,4
russell,1,1,1,1,0,0,4
carpet,0,0,3,1,0,0,4
canyon,0,0,0,0,3,1,4
sensation,0,0,1,1,1,1,4
savior,0,1,1,1,1,0,4
leap,1,0,0,0,0,3,4
injustice,1,0,2,1,0,0,4
wonder,0,0,1,1,1,1,4
translator,0,0,0,0,4,0,4
shack,1,0,0,0,1,2,4
make,1,0,1,1,0,1,4
st.,0,1,1,0,1,1,4
courier,1,0,1,1,1,0,4
rogers,0,2,0,2,0,0,4
designer,0,0,0,1,2,1,4
pyre,0,1,0,1,0,2,4
housewife,0,1,1,0,0,2,4
weather,0,0,1,1,1,1,4
lobby,2,0,0,0,0,2,4
puzzle,2,0,1,0,0,1,4
nick,0,0,1,1,1,1,4
constellation,0,1,0,3,0,0,4
investigator,2,0,0,1,0,1,4
leonard,1,0,0,3,0,0,4
teddy,1,0,1,1,1,0,4
caller,1,0,0,0,1,2,4
whiskey,0,0,1,1,1,1,4
brian,0,0,2,1,1,0,4
ideology,1,2,1,0,0,0,4
decay,0,0,0,1,0,3,4
altar,0,1,1,1,0,1,4
luggage,0,0,3,0,0,1,4
federation,0,0,0,4,0,0,4
mutiny,0,0,0,3,1,0,4
lunge,0,0,0,1,0,3,4
anton,1,0,1,0,0,2,4
debate,1,0,0,2,1,0,4
lane,0,0,0,2,1,1,4
scroll,0,1,0,0,2,1,4
ignorance,0,0,3,0,1,0,4
orphanage,1,0,1,0,1,1,4
san francisco,1,0,0,3,0,0,4
homeland,2,0,0,0,2,0,4
admiration,3,0,0,0,1,0,4
organ,0,0,0,2,0,2,4
dimension,0,0,0,2,0,2,4
specimen,2,0,0,2,0,0,4
campaign,1,0,0,2,1,0,4
egg,1,0,1,2,0,0,4
hallucination,0,0,0,1,0,3,4
jin,1,0,0,2,1,0,4
album,1,0,2,1,0,0,4
asteroid,0,0,0,4,0,0,4
tongue,1,0,1,1,1,0,4
scrap,0,0,0,4,0,0,4
hallway,0,0,0,2,0,2,4
probe,0,0,0,3,0,1,4
drawing,0,1,1,1,1,0,4
habit,0,0,3,0,0,1,4
dam,1,2,0,0,1,0,4
jonathan,1,0,0,2,0,1,4
satan,0,0,0,1,0,3,4
manor,2,0,1,1,0,0,4
torch,0,1,0,2,0,1,4
recluse,1,0,2,1,0,0,4
chapter,0,1,0,3,0,0,4
exam,0,0,4,0,0,0,4
hunchback,0,0,0,1,1,2,4
pod,0,0,0,3,0,1,4
cord,0,0,0,1,0,3,4
groom,1,1,1,0,1,0,4
cia,0,2,0,2,0,0,4
complaint,1,1,1,0,1,0,4
faction,1,1,0,0,2,0,4
chemical,0,0,0,3,1,0,4
reunion,2,0,0,0,1,1,4
female,1,0,1,2,0,0,4
poisoning,0,0,0,3,0,1,4
motto,0,1,2,0,1,0,4
ploy,1,1,0,1,1,0,4
freelance,1,2,0,0,0,1,4
recovers,1,0,0,1,1,1,4
vanishes,0,0,0,1,0,3,4
cube,0,0,0,3,0,1,4
thorn,0,0,0,2,0,2,4
farmhouse,0,0,1,1,0,2,4
poem,0,0,2,1,1,0,4
kansas,0,0,1,1,2,0,4
buck,1,0,0,1,2,0,4
walter,2,0,1,1,0,0,4
satellite,0,0,0,4,0,0,4
rib,0,0,2,1,0,1,4
zamindar,1,1,1,0,1,0,4
horizon,0,0,0,2,2,0,4
ink,1,0,0,1,2,0,4
data,0,1,1,2,0,0,4
manuscript,2,0,1,0,0,1,4
importance,0,0,3,0,1,0,4
firm,0,0,2,1,0,1,4
playwright,2,0,0,2,0,0,4
el,0,0,0,1,2,1,4
saloon,0,0,0,1,3,0,4
spike,0,0,0,2,1,1,4
savage,0,0,0,1,1,2,4
clash,0,0,2,0,2,0,4
faint,0,0,0,1,1,2,4
tone,0,0,0,2,2,0,4
convinces,0,0,2,1,1,0,4
audition,1,0,2,1,0,0,4
walk,1,0,0,1,1,1,4
prompt,1,0,1,2,0,0,4
mud,1,0,0,2,1,0,4
certificate,0,0,1,1,2,0,4
anjali,0,0,3,0,1,0,4
echo,0,1,2,1,0,0,4
scale,2,0,0,2,0,0,4
sketch,0,1,0,1,2,0,4
smoke,0,0,1,1,1,1,4
corporal,2,0,0,0,2,0,4
joy,0,0,3,1,0,0,4
disturbance,0,0,0,1,0,3,4
pot,0,0,2,2,0,0,4
heat,1,1,0,2,0,0,4
stuart,0,1,0,0,1,2,4
trench,1,0,2,0,1,0,4
defendant,2,1,0,0,1,0,4
beggar,0,0,1,0,3,0,4
significance,0,1,0,0,2,1,4
bike,0,0,1,1,2,0,4
cafe,0,0,1,3,0,0,4
battery,0,0,1,2,1,0,4
jewelry,1,0,3,0,0,0,4
shiva,0,0,3,0,1,0,4
lifetime,0,0,0,1,0,3,4
suitcase,2,0,2,0,0,0,4
molotov,0,0,0,1,1,2,4
rufus,0,0,1,2,1,0,4
shankar,0,1,2,0,1,0,4
sweet,0,0,1,1,0,2,4
bangalore,0,0,1,0,2,1,4
saving,0,0,1,2,1,0,4
andrews,0,0,1,0,2,1,4
replacement,1,0,1,1,1,0,4
variation,1,0,1,1,0,1,4
visa,0,0,2,0,2,0,4
voiceover,1,0,1,1,0,1,4
zoom,0,0,2,1,0,1,4
anchor,0,1,1,1,1,0,4
rubble,0,0,0,3,1,0,4
keeper,0,0,2,0,0,2,4
catastrophe,0,0,1,1,0,2,4
branch,1,0,0,3,0,0,4
charlotte,1,1,1,0,0,1,4
crush,0,0,3,0,0,1,4
yellow,0,0,2,1,0,1,4
sequel,0,0,1,2,1,0,4
pakistan,0,1,1,0,2,0,4
quarrel,0,2,0,0,2,0,4
oxygen,1,0,0,3,0,0,4
reply,0,0,1,0,0,3,4
square,0,0,1,0,2,1,4
egypt,1,2,0,0,0,1,4
tanker,1,1,0,2,0,0,4
motherland,1,2,1,0,0,0,4
disappointment,0,0,2,0,2,0,4
sink,1,0,1,1,1,0,4
convoy,1,0,0,0,2,1,4
proceeding,1,1,0,0,2,0,4
salvation,0,0,1,1,1,1,4
comment,1,2,0,0,1,0,4
roman catholic,0,1,0,0,1,2,4
disbelief,1,0,0,1,1,1,4
elite,1,0,2,0,0,1,4
resort,0,0,0,2,1,1,4
spark,0,0,2,2,0,0,4
tune,0,0,3,0,1,0,4
scientists,0,0,0,4,0,0,4
platform,0,0,0,4,0,0,4
industrialist,0,2,1,0,1,0,4
poet,0,1,3,0,0,0,4
revolt,2,0,0,0,2,0,4
superior,1,0,0,2,1,0,4
exploit,2,0,1,0,1,0,4
lorraine,1,0,0,3,0,0,4
switzerland,0,0,1,2,1,0,4
greed,1,0,1,0,1,1,4
daylight,0,0,0,1,1,2,4
exception,0,1,3,0,0,0,4
gallows,1,0,1,0,1,1,4
outburst,2,0,0,1,0,1,4
secrecy,1,0,1,1,0,1,4
delight,2,0,1,0,1,0,4
graham,0,0,0,2,2,0,4
focus,0,1,1,0,2,0,4
standard,0,1,3,0,0,0,4
bishop,1,0,0,0,3,0,4
meat,0,1,0,0,0,3,4
prospect,0,0,0,2,2,0,4
burning,0,0,0,1,1,2,4
completion,1,0,2,0,0,1,4
underground,0,0,0,2,0,2,4
sort,0,0,1,1,0,2,4
locomotive,0,1,0,1,2,0,4
sunday,0,3,0,0,0,1,4
wallet,0,1,2,1,0,0,4
tony,2,0,0,1,0,1,4
flyer,0,0,0,1,2,1,4
demolition,0,1,1,1,1,0,4
admission,0,0,3,0,0,1,4
devotion,1,0,1,1,1,0,4
launch,1,0,1,2,0,0,4
dvd,0,0,1,2,1,0,4
rahul,0,0,3,0,1,0,4
errand,2,0,1,1,0,0,4
siren,0,0,0,3,0,1,4
tap,0,2,0,1,0,1,4
hitler,3,0,0,0,1,0,4
alex,0,0,0,2,0,2,4
gene,1,0,1,1,0,1,4
priority,3,0,0,0,1,0,4
hostility,0,0,0,1,2,1,4
adolf,3,0,0,0,1,0,4
landlady,0,1,0,1,1,1,4
butler,0,0,0,2,0,2,4
jerry,0,0,2,1,0,1,4
mafia,2,0,0,2,0,0,4
armor,2,0,0,0,1,1,4
anderson,1,0,1,0,2,0,4
h.,1,0,0,1,2,0,4
chicken,2,0,0,1,0,1,4
sydney,1,1,1,0,1,0,4
briefcase,2,0,1,0,1,0,4
tender,2,1,0,0,1,0,4
ajay,1,0,2,0,1,0,4
historian,1,2,0,1,0,0,4
private,2,0,1,0,1,0,4
neo,2,0,0,2,0,0,4
buddhist,1,1,0,0,1,1,4
stash,2,0,0,1,0,1,4
moe,3,0,1,0,0,0,4
nevada,2,0,0,0,2,0,4
infidelity,1,1,1,1,0,0,4
matrix,1,0,0,3,0,0,4
judgment,3,0,0,0,0,1,4
new year's eve,1,0,0,1,0,2,4
limbo,1,1,0,0,0,2,4
subconscious,1,1,0,2,0,0,4
inheritance,2,0,1,0,1,0,4
maurice,1,1,1,0,0,1,4
supervision,2,0,0,0,2,0,4
roll,3,0,0,0,1,0,4
misunderstanding,1,0,2,0,0,1,4
regiment,2,0,0,0,2,0,4
wallace,2,0,0,0,2,0,4
turkish,2,0,1,0,1,0,4
print,2,0,0,0,1,1,4
trickery,1,0,1,0,1,1,4
m.,1,1,0,2,0,0,4
season,1,0,1,1,0,1,4
sum,2,1,0,0,1,0,4
miracle,2,0,2,0,0,0,4
las,2,0,0,1,1,0,4
warfare,2,1,1,0,0,0,4
highway,2,0,0,1,1,0,4
radha,2,1,1,0,0,0,4
bachelor,1,0,2,1,0,0,4
harvey,2,0,0,0,2,0,4
misgiving,1,0,1,1,0,1,4
hong,1,0,0,1,1,1,4
wrath,1,1,2,0,0,0,4
pow,2,0,0,0,2,0,4
louisiana,1,1,0,0,0,2,4
attorney,3,0,0,0,1,0,4
booth,1,0,1,0,0,2,4
1930s,2,0,0,0,2,0,4
katana,1,0,0,0,3,0,4
grocery,2,0,0,1,0,1,4
jr.,2,1,0,1,0,0,4
infantry,1,0,0,0,3,0,4
willie,1,0,0,0,3,0,4
lookout,1,0,0,2,1,0,4
ideal,1,0,3,0,0,0,4
prologue,2,0,1,1,0,0,4
anthony,2,1,0,0,0,1,4
antonio,2,0,0,0,1,1,4
kick,1,1,0,0,1,1,4
competitor,2,1,1,0,0,0,4
tomorrow,2,1,0,0,0,1,4
laundry,2,0,0,1,0,1,4
payoff,3,0,0,0,0,1,4
approval,3,0,0,0,1,0,4
seppuku,2,0,0,0,2,0,4
trigger,1,0,1,1,0,1,4
gravity,1,1,0,1,1,0,4
screenplay,1,0,0,0,2,1,4
outside,2,0,0,2,0,0,4
andy,1,0,2,0,1,0,4
shed,1,0,0,0,0,3,4
strategy,2,1,0,1,0,0,4
mayhem,1,0,1,1,0,1,4
d.c.,3,0,0,1,0,0,4
trooper,1,0,1,1,1,0,4
taylor,2,0,0,1,0,1,4
catherine,1,1,2,0,0,0,4
buffalo,3,0,0,0,1,0,4
graduation,1,0,2,1,0,0,4
intruder,1,0,0,1,0,2,4
transfer,2,0,0,1,1,0,4
vegas,2,0,0,1,1,0,4
the,2,0,0,1,1,0,4
collar,2,0,0,0,1,1,4
relief,2,0,0,0,1,1,4
monastery,1,1,0,1,0,1,4
teen,1,0,1,0,0,2,4
standoff,1,0,0,0,2,1,4
norton,3,0,0,0,0,1,4
examination,2,0,0,2,0,0,4
obliges,1,0,1,1,0,1,4
participant,1,2,0,1,0,0,4
sleeping,1,1,1,0,0,1,4
federal,3,0,0,0,1,0,4
warrant,1,0,1,1,1,0,4
wizard,1,0,3,0,0,0,4
rumour,2,1,1,0,0,0,4
odds,1,0,2,0,1,0,4
automobile,3,0,0,1,0,0,4
headline,1,0,0,2,0,1,4
carrier,2,0,0,2,0,0,4
bull,1,0,0,1,2,0,4
fraud,2,1,0,0,0,1,4
inc.,1,1,1,1,0,0,4
auto,2,0,0,2,0,0,4
afghanistan,2,2,0,0,0,0,4
statement,4,0,0,0,0,0,4
stance,1,0,2,1,0,0,4
merry,1,0,0,0,3,0,4
virgil,1,0,0,0,3,0,4
las vegas,2,0,0,1,1,0,4
association,3,0,1,0,0,0,4
pretext,3,0,1,0,0,0,4
temper,2,1,0,0,1,0,4
goodwill,1,0,1,1,1,0,4
kennedy,2,0,0,0,1,1,4
banker,1,0,2,0,1,0,4
stump,1,0,1,1,0,1,4
graduate,1,2,0,0,0,1,4
hood,2,0,2,0,0,0,4
den,3,0,0,0,1,0,4
bear,2,0,1,1,0,0,4
boss,2,0,0,1,1,0,4
pillow,1,0,1,0,0,2,4
bomber,2,0,1,0,0,1,4
refugee,2,0,0,1,1,0,4
colour,1,0,1,1,0,1,4
ultimatum,2,0,0,1,0,1,4
bunny,1,0,3,0,0,0,4
tide,1,0,0,0,2,1,4
dick,1,1,0,0,1,1,4
lance,2,0,0,0,1,1,4
lucius,3,0,0,0,1,0,4
agreement,1,0,2,1,0,0,4
free,1,1,0,1,1,0,4
locker,2,0,0,0,0,2,4
phillips,1,0,2,0,0,0,3
caption,1,0,0,0,2,0,3
livestock,0,0,1,1,1,0,3
truce,0,0,1,0,0,2,3
b,1,0,1,1,0,0,3
conway,2,1,0,0,0,0,3
ace,0,0,2,1,0,0,3
ton,0,0,0,2,1,0,3
muslims,2,1,0,0,0,0,3
sleeve,0,0,1,0,0,2,3
martyr,0,0,1,0,0,2,3
eternity,0,0,1,1,0,1,3
guerilla,0,0,0,3,0,0,3
fascination,0,1,1,0,0,1,3
wrongdoing,1,0,1,0,1,0,3
prelude,1,0,1,0,0,1,3
contempt,0,0,1,0,2,0,3
tannen,0,0,0,3,0,0,3
overdose,2,0,0,1,0,0,3
metaphor,0,2,1,0,0,0,3
brooklyn,2,1,0,0,0,0,3
holiday,0,0,0,0,2,1,3
adrian,0,1,0,0,1,1,3
chauffeur,1,1,0,0,1,0,3
sympathizer,1,0,1,0,0,1,3
swan,0,1,1,0,1,0,3
containment,1,0,0,2,0,0,3
brett,1,0,0,1,1,0,3
patriarch,0,0,1,0,1,1,3
serbia,1,1,1,0,0,0,3
k.,0,1,0,0,2,0,3
accuracy,1,1,0,0,0,1,3
plaza,0,1,1,0,0,1,3
subordinate,2,0,0,0,1,0,3
flamethrower,0,0,0,2,0,1,3
the vietnam war,0,1,1,0,0,1,3
feigns,1,0,0,1,0,1,3
debauchery,0,0,0,0,1,2,3
lineage,0,2,0,1,0,0,3
anti,0,0,0,1,2,0,3
disapproval,0,1,2,0,0,0,3
grip,1,0,0,0,0,2,3
dumpling,1,0,1,0,0,1,3
contraption,0,0,1,0,0,2,3
harness,0,0,1,0,0,2,3
panchayat,1,2,0,0,0,0,3
exhibit,0,1,0,0,0,2,3
incompetence,0,1,0,1,1,0,3
philip,0,1,0,1,0,1,3
marketplace,0,0,2,0,0,1,3
screaming,0,1,0,1,0,1,3
jump,2,0,0,1,0,0,3
dose,2,0,0,0,0,1,3
memento,0,0,1,2,0,0,3
soil,0,0,1,2,0,0,3
rhyme,0,0,1,1,0,1,3
christine,0,0,0,1,0,2,3
dive,1,0,1,0,0,1,3
gypsy,0,2,0,1,0,0,3
garage,0,0,0,2,0,1,3
denial,1,1,0,1,0,0,3
brad,0,0,0,1,1,1,3
lawrence,0,1,0,0,2,0,3
quicksand,0,0,0,1,2,0,3
stockholm,1,0,0,1,0,1,3
biff,0,0,0,3,0,0,3
u.s. navy,1,0,0,2,0,0,3
evolution,0,0,0,2,0,1,3
madame,0,0,0,0,1,2,3
replica,0,1,0,1,1,0,3
depot,1,1,0,0,1,0,3
cotton,0,0,0,0,2,1,3
jaw,1,0,0,1,0,1,3
saruman,1,0,0,0,2,0,3
narcotic,3,0,0,0,0,0,3
pace,0,0,0,0,3,0,3
vienna,1,0,2,0,0,0,3
lap,1,1,0,0,1,0,3
monsters,0,0,1,1,0,1,3
flute,1,0,1,0,1,0,3
israel,1,0,0,0,1,1,3
cambodia,1,1,0,1,0,0,3
canada,1,0,0,1,0,1,3
delorean,0,0,0,3,0,0,3
supervisor,0,0,0,2,1,0,3
elrond,1,0,0,0,2,0,3
the moon,0,1,0,2,0,0,3
acrobat,0,1,0,0,2,0,3
jake,0,0,0,0,2,1,3
mcfly,0,0,0,3,0,0,3
fee,0,0,0,0,2,1,3
penthouse,1,0,1,0,0,1,3
arwen,1,0,0,0,2,0,3
hymn,0,0,1,1,1,0,3
y,0,3,0,0,0,0,3
fork,1,0,0,0,1,1,3
void,0,0,0,3,0,0,3
rathod,0,0,2,0,1,0,3
orb,0,2,0,1,0,0,3
dave,0,0,0,2,0,1,3
nazgûl,1,0,0,0,2,0,3
i.,1,0,1,1,0,0,3
mistrust,0,0,0,1,2,0,3
pole,0,0,0,1,1,1,3
seattle,1,0,0,2,0,0,3
rooftop,1,0,1,0,1,0,3
toby,0,1,0,1,0,1,3
bundle,0,0,1,1,1,0,3
stronghold,0,0,0,1,2,0,3
motionless,0,0,0,1,0,2,3
illinois,2,0,0,0,1,0,3
aisle,0,0,1,2,0,0,3
penniless,0,1,2,0,0,0,3
submarine,1,0,0,2,0,0,3
log,1,0,0,1,1,0,3
new england,0,0,0,1,0,2,3
williams,1,0,0,0,0,2,3
take,0,0,0,1,1,1,3
misunderstood,0,0,3,0,0,0,3
captive,0,0,0,0,1,2,3
turner,0,1,0,1,1,0,3
pioneer,0,1,0,1,1,0,3
left,1,0,1,0,0,1,3
hobbits,1,0,0,0,2,0,3
pentagon,2,1,0,0,0,0,3
abu,0,1,1,0,1,0,3
fistfight,1,0,0,1,1,0,3
nickname,0,0,2,0,1,0,3
outspokenness,0,0,1,0,2,0,3
randall,1,0,1,0,0,1,3
elise,1,0,0,1,0,1,3
recoil,1,0,0,0,1,1,3
jai,0,0,1,0,2,0,3
hurl,0,0,0,0,1,2,3
agatha,0,1,1,0,0,1,3
android,0,0,0,3,0,0,3
poe,0,0,0,0,0,3,3
orc,1,0,0,0,2,0,3
impostor,1,0,0,0,1,1,3
supermarket,0,1,0,0,2,0,3
mention,0,0,0,1,0,2,3
morale,1,0,0,0,2,0,3
the royal navy,1,0,0,0,2,0,3
courthouse,1,0,0,2,0,0,3
virginia,1,0,0,0,1,1,3
monitor,0,0,0,1,1,1,3
spock,0,0,0,3,0,0,3
cadet,0,0,0,2,1,0,3
extortion,1,0,0,0,1,1,3
pattern,1,0,1,1,0,0,3
juan,0,0,0,0,1,2,3
lakh,0,1,1,0,1,0,3
mukesh,0,1,0,0,1,1,3
grey,1,0,0,0,1,1,3
ellen,1,0,1,0,0,1,3
current,0,0,1,1,1,0,3
rekha,0,1,1,0,1,0,3
pike,0,0,0,1,2,0,3
starship,0,0,0,3,0,0,3
crossroad,0,0,1,0,1,1,3
swordsmanship,0,0,0,0,3,0,3
paperwork,0,0,1,1,0,1,3
directory,0,1,0,1,0,1,3
making,3,0,0,0,0,0,3
amends,0,1,1,0,1,0,3
convert,0,1,0,2,0,0,3
lewis,1,1,0,0,0,1,3
heroine,1,2,0,0,0,0,3
gunman,0,0,0,0,3,0,3
gondor,1,0,0,0,2,0,3
poetry,2,0,0,1,0,0,3
taoist,0,0,0,0,0,3,3
excursion,0,1,2,0,0,0,3
attendant,1,2,0,0,0,0,3
brush,1,0,1,0,1,0,3
profile,0,1,1,0,1,0,3
regard,0,2,1,0,0,0,3
nun,0,0,2,0,0,1,3
karen,1,0,0,1,0,1,3
warlord,0,0,0,2,1,0,3
dig,0,0,0,0,1,2,3
cobra,0,1,1,1,0,0,3
naga,0,1,0,1,1,0,3
bombardment,0,0,0,3,0,0,3
tibet,0,1,0,2,0,0,3
jason,0,0,0,1,0,2,3
milk,0,1,0,1,0,1,3
copper,0,0,1,2,0,0,3
bonfire,0,0,0,1,0,2,3
rani,0,2,0,0,1,0,3
meanwhile,2,0,1,0,0,0,3
untouchable,0,2,1,0,0,0,3
initiation,0,1,0,0,0,2,3
quarantine,1,0,0,2,0,0,3
tactic,1,0,2,0,0,0,3
la,1,1,1,0,0,0,3
decoy,0,0,0,0,3,0,3
hunger,0,1,1,1,0,0,3
doorway,0,0,0,2,0,1,3
abbey,0,0,1,0,0,2,3
offense,2,0,1,0,0,0,3
battlefield,1,1,0,0,1,0,3
edgar,0,0,0,0,0,3,3
schroeder,0,0,1,0,0,2,3
ministry,2,0,0,1,0,0,3
filming,0,1,1,1,0,0,3
unity,1,0,1,1,0,0,3
sauron,1,0,0,0,2,0,3
idiot,1,0,1,0,1,0,3
aragorn,1,0,0,0,2,0,3
planning,1,0,0,0,2,0,3
tenet,0,2,1,0,0,0,3
ramon,0,0,0,0,3,0,3
beer,0,0,1,1,1,0,3
rangers,0,0,0,0,3,0,3
burden,0,0,0,0,3,0,3
flee,0,0,0,0,2,1,3
officials,0,1,0,1,1,0,3
corporation,1,1,0,0,1,0,3
penitentiary,3,0,0,0,0,0,3
verma,0,1,2,0,0,0,3
austria,0,0,2,0,1,0,3
dynamite,0,0,0,0,2,1,3
closet,0,0,1,0,0,2,3
parole,2,0,0,0,1,0,3
chieftain,1,0,2,0,0,0,3
khan,1,1,1,0,0,0,3
sean,1,1,0,0,0,1,3
telescope,0,1,0,2,0,0,3
cocktail,1,0,0,1,0,1,3
shuttle,0,0,0,3,0,0,3
trolley,0,0,0,1,2,0,3
nri,1,1,1,0,0,0,3
battalion,1,0,0,0,2,0,3
lamp,0,1,1,1,0,0,3
yard,0,0,0,2,0,1,3
laser,0,1,0,2,0,0,3
dad,0,0,1,1,1,0,3
pardon,0,1,0,0,2,0,3
youngster,1,1,1,0,0,0,3
critic,1,1,1,0,0,0,3
scalp,1,0,0,1,0,1,3
succession,0,0,1,0,1,1,3
nations,0,1,0,1,1,0,3
variety,0,0,0,1,1,1,3
sniper,2,0,0,0,1,0,3
samuel,1,0,0,0,2,0,3
santa,0,0,0,1,1,1,3
dale,1,0,0,2,0,0,3
vega,1,0,0,2,0,0,3
pete,0,0,0,2,0,1,3
sale,1,0,0,0,1,1,3
babu,1,0,2,0,0,0,3
penalty,0,1,1,0,1,0,3
coldness,0,0,0,1,1,1,3
rama,1,0,0,0,1,1,3
miller,2,0,0,0,0,1,3
array,1,1,1,0,0,0,3
wager,0,0,1,1,0,1,3
reich,0,1,1,0,1,0,3
hub,1,0,0,0,2,0,3
resentment,0,1,1,0,1,0,3
ryan,2,0,0,0,1,0,3
heritage,1,1,0,1,0,0,3
circle,1,0,2,0,0,0,3
imprisonment,0,0,1,0,1,1,3
commitment,1,0,1,0,1,0,3
short,1,0,1,1,0,0,3
isengard,1,0,0,0,2,0,3
lecturer,0,1,1,1,0,0,3
crescendo,0,0,0,2,0,1,3
pen,1,0,1,0,0,1,3
annie,0,0,0,1,0,2,3
cloth,0,0,0,3,0,0,3
collides,1,0,0,1,1,0,3
lawman,0,0,0,1,2,0,3
straw,0,0,0,1,2,0,3
mordor,1,0,0,0,2,0,3
finale,0,0,0,2,0,1,3
indira,1,1,0,0,1,0,3
orcs,1,0,0,0,2,0,3
medic,1,0,1,1,0,0,3
spread,0,0,0,0,1,2,3
turret,0,0,0,1,1,1,3
unemployment,0,1,2,0,0,0,3
storeroom,0,0,0,0,2,1,3
breed,1,0,0,1,0,1,3
barber,0,1,1,0,0,1,3
der,2,1,0,0,0,0,3
administrator,0,1,2,0,0,0,3
hysteria,0,0,1,0,0,2,3
conspiracy,1,0,0,0,1,1,3
musical,0,0,1,1,0,1,3
berlin,1,1,0,0,0,1,3
intermission,0,0,0,1,2,0,3
bhai,1,0,2,0,0,0,3
legolas,1,0,0,0,2,0,3
reverse,0,0,0,2,1,0,3
mac,1,0,0,1,0,1,3
lift,0,0,1,1,0,1,3
phase,0,1,0,0,2,0,3
recorder,0,0,0,1,0,2,3
ganesh,0,1,2,0,0,0,3
amnesia,1,1,1,0,0,0,3
scorpion,0,0,0,1,1,1,3
bilbo,1,0,0,0,2,0,3
perception,0,2,0,0,0,1,3
bartender,1,0,0,1,0,1,3
therapy,1,0,1,1,0,0,3
bombay,1,0,1,0,1,0,3
ankle,0,0,1,0,1,1,3
razor,0,1,0,0,0,2,3
anonymity,1,0,0,0,0,2,3
blind,0,0,1,0,0,2,3
gollum,1,0,0,0,2,0,3
clara,1,1,0,1,0,0,3
introduction,0,1,1,1,0,0,3
enmity,0,2,0,0,1,0,3
boxcar,0,0,0,1,2,0,3
gimli,1,0,0,0,2,0,3
alma,0,0,0,0,1,2,3
wrestler,0,1,0,0,0,2,3
fixture,1,0,0,1,0,1,3
bang,0,1,0,2,0,0,3
arizona,0,0,0,1,2,0,3
lawn,0,1,0,1,0,1,3
fade,0,1,0,1,1,0,3
injection,1,0,0,2,0,0,3
nathan,0,1,0,0,1,1,3
m,1,0,0,0,1,1,3
steam,1,0,0,0,1,1,3
mail,1,0,1,1,0,0,3
vincent,2,0,0,1,0,0,3
badge,2,0,0,0,1,0,3
fingerprint,2,0,0,0,1,0,3
pimp,1,0,0,0,0,2,3
mars,0,1,0,2,0,0,3
sincerity,1,1,0,0,1,0,3
pippin,1,0,0,0,2,0,3
procedure,0,0,0,2,0,1,3
invention,0,1,1,1,0,0,3
archival,0,3,0,0,0,0,3
interrupt,0,0,0,0,1,2,3
comic,0,0,0,1,0,2,3
exploration,0,1,0,2,0,0,3
1970s,0,0,0,1,0,2,3
panel,1,0,0,0,1,1,3
harris,0,1,0,2,0,0,3
penis,0,0,0,1,1,1,3
gandalf,1,0,0,0,2,0,3
welcome,1,0,2,0,0,0,3
philosophy,0,1,2,0,0,0,3
dispute,2,0,0,0,1,0,3
detonates,1,0,0,2,0,0,3
stowaway,1,0,0,2,0,0,3
helsing,0,0,0,0,0,3,3
emmett,0,0,0,3,0,0,3
flooding,0,1,1,0,1,0,3
jerusalem,1,0,0,0,2,0,3
legacy,0,0,0,3,0,0,3
blanket,0,1,0,0,1,1,3
memorial,1,1,1,0,0,0,3
simulation,1,0,1,1,0,0,3
alert,1,0,0,1,0,1,3
fusion,1,0,0,1,0,1,3
anticipation,1,0,1,0,1,0,3
intellect,0,0,0,3,0,0,3
drill,1,0,0,2,0,0,3
exhaustion,1,0,2,0,0,0,3
composer,1,0,1,1,0,0,3
reactor,1,0,0,2,0,0,3
hot,1,0,0,1,1,0,3
attendee,0,0,0,1,0,2,3
wisdom,0,0,0,1,1,1,3
erik,0,0,0,1,0,2,3
interpretation,0,0,1,1,0,1,3
pantry,0,0,1,0,0,2,3
laughing,0,0,1,0,1,1,3
drifter,0,0,0,0,1,2,3
lollipop,0,1,1,0,1,0,3
nambiar,0,3,0,0,0,0,3
gain,0,0,1,2,0,0,3
non,1,0,1,1,0,0,3
liquid,1,0,1,1,0,0,3
charity,0,1,2,0,0,0,3
down,1,1,0,0,0,1,3
chinna,0,2,0,0,1,0,3
restroom,1,0,0,0,1,1,3
raghu,0,1,2,0,0,0,3
parody,0,1,1,0,1,0,3
sara,0,0,1,2,0,0,3
madurai,0,0,1,0,2,0,3
hitman,2,0,1,0,0,0,3
matt,0,0,0,1,2,0,3
sreenivasan,0,1,0,0,1,1,3
shout,2,0,0,1,0,0,3
bout,1,0,0,0,1,1,3
russia,2,0,0,0,0,1,3
needle,0,0,0,1,0,2,3
user,0,1,0,2,0,0,3
melee,0,0,0,0,2,1,3
reagan,0,2,0,0,0,1,3
screening,1,0,1,0,1,0,3
andrew,0,0,1,1,0,1,3
donation,2,0,1,0,0,0,3
container,0,0,0,1,1,1,3
height,0,0,1,1,0,1,3
nosferatu,0,0,0,1,0,2,3
frodo,1,0,0,0,2,0,3
weary,0,0,0,0,2,1,3
ford,0,0,0,1,2,0,3
marvin,1,0,0,1,1,0,3
psychology,0,1,0,1,0,1,3
bowl,0,0,2,1,0,0,3
poster,2,1,0,0,0,0,3
protocol,0,0,0,3,0,0,3
ninja,0,0,0,0,3,0,3
marines,2,0,1,0,0,0,3
churchill,3,0,0,0,0,0,3
butcher,0,0,0,1,0,2,3
opposition,1,1,0,0,1,0,3
francis,1,1,0,0,1,0,3
cup,0,1,1,1,0,0,3
mute,0,0,0,1,1,1,3
battleship,0,0,0,3,0,0,3
win,0,0,2,1,0,0,3
hugo,1,1,0,0,0,1,3
partying,2,0,1,0,0,0,3
polish,2,1,0,0,0,0,3
sherman,1,0,1,0,1,0,3
oz,0,0,1,2,0,0,3
alter,0,0,0,2,1,0,3
questioning,1,0,1,0,0,1,3
mourning,1,0,1,0,1,0,3
gale,0,0,1,1,0,1,3
hill valley,0,0,0,3,0,0,3
days,0,0,1,2,0,0,3
christians,0,3,0,0,0,0,3
recognition,0,0,1,0,2,0,3
bubble,0,0,1,2,0,0,3
greek,0,0,0,1,0,2,3
enraged,1,0,0,0,1,1,3
lincoln,2,0,0,1,0,0,3
toe,0,0,1,0,1,1,3
breakfast,2,0,0,1,0,0,3
culprit,0,0,0,1,2,0,3
stereotype,0,2,0,0,0,1,3
freighter,1,0,0,1,0,1,3
crane,1,0,0,1,0,1,3
nursery,0,0,1,0,0,2,3
payroll,1,0,1,0,1,0,3
metropolis,0,0,0,3,0,0,3
puppet,0,1,1,0,1,0,3
yuki,0,0,0,2,1,0,3
cab,0,0,1,0,0,2,3
wrestling,0,1,2,0,0,0,3
hearing,1,0,0,2,0,0,3
baker,1,0,0,0,2,0,3
grudge,0,2,0,0,1,0,3
capt,0,0,0,0,2,1,3
warship,1,0,0,1,1,0,3
informer,1,0,0,0,2,0,3
medallion,0,0,0,0,1,2,3
interior,0,0,2,1,0,0,3
steward,1,0,0,0,2,0,3
townsfolk,0,0,0,0,2,1,3
halt,0,0,3,0,0,0,3
faculty,0,0,2,1,0,0,3
no,1,0,1,0,0,1,3
harvest,2,0,0,0,1,0,3
acting,2,0,0,0,1,0,3
inferiority,0,0,3,0,0,0,3
stagger,1,0,0,2,0,0,3
off,1,0,1,0,0,1,3
cavern,1,0,0,2,0,0,3
profiteer,2,0,1,0,0,0,3
commoner,0,0,1,0,2,0,3
shortage,0,0,1,2,0,0,3
flood,1,1,1,0,0,0,3
crypt,0,0,0,0,0,3,3
exorcism,0,0,0,0,0,3,3
glimpse,1,1,1,0,0,0,3
tomb,1,0,0,0,0,2,3
hooker,1,0,0,0,1,1,3
schedule,0,0,0,1,1,1,3
shogun,1,0,0,0,2,0,3
awareness,0,0,2,1,0,0,3
tess,0,0,0,0,3,0,3
blacksmith,0,0,1,0,1,1,3
setback,0,0,2,1,0,0,3
thunder,0,0,1,2,0,0,3
tribesman,0,0,0,0,3,0,3
b.,3,0,0,0,0,0,3
guitar,0,0,2,0,1,0,3
scissors,0,0,1,1,0,1,3
committee,1,0,0,0,1,1,3
concubine,1,1,0,0,1,0,3
freak,0,0,1,1,0,1,3
del,1,0,0,1,0,1,3
sufferer,1,1,1,0,0,0,3
solitude,0,0,0,1,1,1,3
holmes,1,0,0,2,0,0,3
simran,1,0,1,0,1,0,3
miles,1,0,0,1,1,0,3
a.,0,0,1,1,0,1,3
manifestation,0,0,0,1,0,2,3
apple,1,0,0,1,0,1,3
turk,2,0,0,0,1,0,3
galley,0,0,1,1,1,0,3
irish,1,0,0,1,1,0,3
great britain,0,0,0,0,2,1,3
expression,2,0,0,0,0,1,3
eva,0,0,2,0,0,1,3
rendezvous,0,0,1,0,0,2,3
bankruptcy,1,0,2,0,0,0,3
depart,1,0,0,2,0,0,3
exorcist,0,0,0,0,0,3,3
sullivan,1,0,1,1,0,0,3
columbus,0,0,0,2,0,1,3
humility,1,1,0,0,1,0,3
apathy,0,0,1,1,0,1,3
closure,0,0,0,1,1,1,3
hal,1,0,1,1,0,0,3
intoxication,0,0,1,1,0,1,3
playing,2,0,0,0,0,1,3
jean,1,1,0,0,0,1,3
chinatown,2,0,0,0,0,1,3
transport,0,1,0,1,1,0,3
creator,0,0,0,2,1,0,3
conquest,1,1,0,0,1,0,3
attendance,1,0,1,0,0,1,3
wales,0,1,1,0,1,0,3
bungalow,1,1,1,0,0,0,3
tracker,1,0,0,1,1,0,3
verdict,1,1,0,1,0,0,3
coworker,1,0,0,2,0,0,3
sack,0,0,0,0,2,1,3
fiance,1,0,0,1,1,0,3
violet,1,0,0,0,1,1,3
architecture,1,1,0,1,0,0,3
woodcutter,1,0,2,0,0,0,3
obstacle,1,0,0,1,0,1,3
the white house,2,0,0,1,0,0,3
stall,0,0,3,0,0,0,3
lin,0,0,1,1,1,0,3
teller,1,0,1,0,0,1,3
sumerian,0,0,0,2,0,1,3
dash,0,0,1,0,1,1,3
publicity,0,0,1,1,0,1,3
waterfall,0,0,1,1,1,0,3
sculptor,1,0,0,0,0,2,3
downfall,1,0,0,1,0,1,3
rancher,0,0,0,0,3,0,3
jeff,1,0,2,0,0,0,3
native american,0,0,0,0,1,2,3
farming,0,0,1,1,1,0,3
troupe,0,0,1,0,2,0,3
inscription,1,0,0,1,0,1,3
terry,0,0,1,0,1,1,3
projection,2,0,0,1,0,0,3
2nd,2,1,0,0,0,0,3
brothers,1,0,0,1,1,0,3
baggage,0,0,1,0,1,1,3
goose,2,0,1,0,0,0,3
furniture,1,0,1,1,0,0,3
dice,2,0,1,0,0,0,3
terrorism,1,1,0,1,0,0,3
parcel,0,0,1,0,2,0,3
roast,2,0,0,0,0,1,3
loaf,1,2,0,0,0,0,3
interpreter,0,0,0,1,2,0,3
benjamin,2,0,0,0,0,1,3
coincidence,0,0,0,0,3,0,3
welfare,1,0,1,0,1,0,3
pat,1,0,0,1,0,1,3
marcus,1,0,0,0,1,1,3
frontier,1,0,0,0,2,0,3
peggy,1,0,0,0,0,2,3
abduction,0,0,0,1,0,2,3
pillar,0,0,0,3,0,0,3
volcano,0,0,0,2,1,0,3
phrase,0,0,0,2,0,1,3
disorder,1,0,1,1,0,0,3
clone,0,0,0,2,0,1,3
guinea,0,0,0,3,0,0,3
angela,1,0,0,0,1,1,3
russian,0,0,0,1,2,0,3
logic,1,0,2,0,0,0,3
nerve,0,0,0,1,1,1,3
abdomen,1,0,0,0,0,2,3
petal,1,0,1,0,0,1,3
flirtation,2,0,0,1,0,0,3
tutor,0,0,3,0,0,0,3
jew,2,0,1,0,0,0,3
crow,0,0,0,2,0,1,3
inch,0,0,1,1,0,1,3
rome,0,0,0,0,2,1,3
muscle,1,0,0,2,0,0,3
k,0,0,2,1,0,0,3
deva,1,0,1,1,0,0,3
alabama,2,0,1,0,0,0,3
discipline,0,0,0,0,3,0,3
enactment,0,0,2,0,1,0,3
blindness,2,0,1,0,0,0,3
climate,1,1,0,0,1,0,3
kane,1,0,1,1,0,0,3
devi,1,0,1,0,1,0,3
elvis,1,0,0,1,0,1,3
employment,1,1,1,0,0,0,3
martha,0,0,0,2,1,0,3
wasteland,0,0,2,1,0,0,3
cartoon,0,0,2,0,1,0,3
sicily,2,0,0,0,1,0,3
complicity,2,0,0,0,0,1,3
gasoline,0,0,0,1,0,2,3
fist,0,0,0,1,2,0,3
balloon,1,0,2,0,0,0,3
excuse,0,0,2,1,0,0,3
paradigm,1,0,2,0,0,0,3
ruling,1,0,0,1,1,0,3
salt,1,0,1,0,0,1,3
remark,0,0,1,1,1,0,3
livelihood,0,0,1,1,1,0,3
gathering,0,0,2,1,0,0,3
lava,0,0,0,2,1,0,3
remainder,1,0,0,0,1,1,3
robe,0,0,2,0,0,1,3
pendant,0,0,1,0,0,2,3
hindi,0,0,3,0,0,0,3
coordinate,0,0,0,3,0,0,3
reddy,0,0,1,0,2,0,3
projector,1,1,0,1,0,0,3
grin,1,0,0,0,0,2,3
brick,1,0,1,1,0,0,3
clayton,0,0,0,2,1,0,3
wells,0,0,0,1,2,0,3
meek,0,0,0,0,2,1,3
jesse,0,0,1,1,0,1,3
reign,2,0,0,0,1,0,3
tuberculosis,0,0,0,0,2,1,3
hardship,0,0,1,0,2,0,3
explorer,1,0,0,2,0,0,3
rachel,2,0,0,1,0,0,3
pond,0,0,1,1,0,1,3
tribute,2,0,1,0,0,0,3
jurisdiction,2,0,0,0,1,0,3
disgrace,1,0,1,0,1,0,3
tourist,0,0,2,0,0,1,3
coup,1,0,1,0,0,1,3
pact,1,0,0,1,0,1,3
chainsaw,0,0,0,0,0,3,3
witchcraft,0,0,0,0,0,3,3
fallout,0,0,0,3,0,0,3
lyric,2,1,0,0,0,0,3
prosecution,1,0,0,1,1,0,3
thumb,1,0,0,0,0,2,3
sebastian,0,0,0,1,0,2,3
holocaust,1,1,0,1,0,0,3
passageway,0,0,1,0,0,2,3
deep,1,1,0,0,1,0,3
posting,3,0,0,0,0,0,3
fair,0,1,1,1,0,0,3
lip,0,0,2,0,1,0,3
grace,0,0,2,0,0,1,3
pierre,1,0,1,1,0,0,3
mechanic,1,0,0,1,1,0,3
julian,0,1,0,2,0,0,3
capacity,0,0,0,1,2,0,3
g,3,0,0,0,0,0,3
meter,0,0,0,1,2,0,3
chris,2,0,0,0,0,1,3
casting,1,0,0,1,0,1,3
prostitution,2,1,0,0,0,0,3
magician,1,0,1,0,0,1,3
waiter,2,0,1,0,0,0,3
storyline,0,0,0,2,1,0,3
stress,2,1,0,0,0,0,3
mode,0,0,1,1,1,0,3
fright,0,0,0,1,0,2,3
korean,1,0,1,1,0,0,3
cairo,0,1,0,0,1,1,3
immigrant,1,0,2,0,0,0,3
protector,1,0,0,2,0,0,3
freight,1,0,0,1,1,0,3
ill,1,1,1,0,0,0,3
illusion,1,0,0,1,0,1,3
rejoices,1,0,2,0,0,0,3
stupor,0,0,0,0,0,3,3
elephant,0,1,2,0,0,0,3
retainer,1,0,0,0,2,0,3
racism,2,0,0,0,1,0,3
pizza,0,0,1,2,0,0,3
demeanor,0,0,1,0,0,2,3
cruiser,0,0,0,3,0,0,3
junior,0,0,2,0,1,0,3
neil,1,0,0,0,0,2,3
dynasty,0,1,1,0,1,0,3
lloyd,0,1,0,0,0,2,3
engineering,0,0,2,1,0,0,3
laugh,1,0,1,1,0,0,3
deformity,0,0,0,1,0,2,3
patricia,0,0,0,1,1,1,3
setting,1,0,1,0,0,1,3
domination,0,0,0,3,0,0,3
supernova,0,0,0,3,0,0,3
palm,1,0,1,0,1,0,3
hagen,3,0,0,0,0,0,3
button,0,0,1,2,0,0,3
abode,1,1,1,0,0,0,3
rapport,1,0,1,0,1,0,3
justine,1,0,0,1,0,1,3
cape,0,1,0,1,1,0,3
scarecrow,0,0,2,0,0,1,3
krishnan,0,0,2,0,1,0,3
swat,1,0,0,0,1,1,3
embarrassment,1,0,1,0,1,0,3
reptilian,0,0,0,2,0,1,3
basketball,2,0,0,1,0,0,3
hurricane,1,1,1,0,0,0,3
alexander,1,0,0,2,0,0,3
toddler,0,0,1,0,2,0,3
metro,0,0,1,2,0,0,3
minion,1,0,0,1,0,1,3
allan,0,0,0,0,1,2,3
province,1,1,1,0,0,0,3
applause,1,0,1,1,0,0,3
kirk,0,0,0,3,0,0,3
yvonne,0,0,0,0,0,3,3
toast,0,0,0,2,0,1,3
courtesan,1,1,1,0,0,0,3
terrace,0,0,1,2,0,0,3
teaching,1,0,1,1,0,0,3
kay,2,0,0,1,0,0,3
tracking,1,0,0,1,1,0,3
foundation,2,0,1,0,0,0,3
rick,1,1,0,1,0,0,3
firefighter,1,0,0,0,1,1,3
starfleet,0,0,0,3,0,0,3
backup,1,0,0,1,0,1,3
rehearsal,1,0,0,1,0,1,3
vegetable,0,1,1,0,1,0,3
baltimore,1,1,0,0,1,0,3
dungeon,0,0,0,2,0,1,3
prey,0,0,2,1,0,0,3
noose,0,0,1,0,2,0,3
archive,2,0,0,0,0,1,3
adulthood,1,1,0,1,0,0,3
miami,1,1,1,0,0,0,3
colorado,1,0,0,0,1,1,3
shogunate,2,0,0,0,1,0,3
award,1,0,1,1,0,0,3
talkie,0,0,1,1,1,0,3
incarceration,1,0,0,2,0,0,3
mom,0,0,2,0,0,1,3
bradley,0,1,0,0,1,1,3
fog,1,0,1,0,0,1,3
commandant,0,1,0,0,2,0,3
encampment,0,0,0,1,2,0,3
daniel,0,0,1,1,0,1,3
.{{cite,1,0,1,1,0,0,3
nobility,0,0,0,0,1,2,3
bait,0,0,1,0,2,0,3
midget,0,0,1,1,0,1,3
russians,1,0,0,0,1,1,3
taste,1,0,1,0,0,1,3
debris,1,0,0,2,0,0,3
steamer,0,0,0,0,2,1,3
patch,2,0,1,0,0,0,3
cluster,1,1,0,1,0,0,3
presley,1,0,0,1,0,1,3
donald,1,0,0,0,2,0,3
timeline,0,0,1,2,0,0,3
hong kong,1,0,0,1,1,0,3
reese,2,0,0,1,0,0,3
ire,1,0,1,0,1,0,3
widower,1,0,0,1,1,0,3
martian,0,0,1,2,0,0,3
platoon,3,0,0,0,0,0,3
orange,1,0,1,0,1,0,3
missouri,0,1,0,0,2,0,3
super,0,0,0,2,1,0,3
decline,0,0,0,1,1,1,3
cane,0,0,1,1,0,1,3
col,0,0,1,0,2,0,3
wreckage,0,0,0,2,1,0,3
sandra,0,0,1,1,0,1,3
melodrama,1,0,0,2,0,0,3
brand,0,0,0,0,3,0,3
dictator,1,0,1,1,0,0,3
pawn,1,0,0,0,0,2,3
crop,1,0,0,0,2,0,3
melody,0,0,1,1,0,1,3
jury,1,1,0,0,0,1,3
blanc,1,0,1,0,0,1,3
inventor,1,0,1,1,0,0,3
tin,1,0,2,0,0,0,3
belonging,1,0,1,1,0,0,3
pianist,1,1,1,0,0,0,3
earl,0,0,0,1,1,1,3
spectre,0,0,1,1,0,1,3
pseudonym,1,0,0,2,0,0,3
world war i,0,1,1,1,0,0,3
loophole,1,0,0,1,1,0,3
flick,1,0,1,0,0,1,3
prejudice,1,1,1,0,0,0,3
labyrinth,1,0,0,0,0,2,3
broadway,0,0,1,1,0,1,3
predator,0,0,0,2,1,0,3
recount,1,0,0,0,1,1,3
cruelty,1,0,0,0,2,0,3
tokugawa,0,0,0,1,2,0,3
stunt,0,0,1,1,1,0,3
starvation,2,0,0,0,0,1,3
belt,1,0,1,1,0,0,3
hawkins,0,0,0,3,0,0,3
the united states army,1,0,0,2,0,0,3
dutch,1,0,0,1,1,0,3
garrison,0,0,0,0,3,0,3
decrepit,2,0,0,0,1,0,3
pearl,1,1,0,0,1,0,3
edwin,0,1,0,0,1,0,2
motorcyclist,0,0,0,0,0,2,2
bookmark,1,0,0,1,0,0,2
manipulator,0,0,0,1,0,1,2
lantern,0,1,0,0,0,1,2
romero,0,0,0,0,0,2,2
astronomer,0,1,0,1,0,0,2
high,0,1,0,0,0,1,2
forrester,0,0,0,1,0,1,2
dwarf,1,0,0,0,0,1,2
gardener,2,0,0,0,0,0,2
teresa,0,2,0,0,0,0,2
broker,1,0,1,0,0,0,2
carol,1,0,0,1,0,0,2
yearns,0,0,2,0,0,0,2
ballroom,0,0,1,0,1,0,2
ricky,1,0,0,1,0,0,2
ranjith,0,0,1,0,1,0,2
eclipse,0,0,0,1,1,0,2
specialty,0,1,0,1,0,0,2
makeup,0,0,1,1,0,0,2
crystalline,0,1,0,1,0,0,2
businessmen,1,0,0,1,0,0,2
hobbit,1,0,0,0,1,0,2
burnham,1,0,0,0,1,0,2
carmen,1,0,0,0,0,1,2
smoker,1,1,0,0,0,0,2
zealand,1,0,0,1,0,0,2
see,0,0,1,1,0,0,2
brahmin,0,1,1,0,0,0,2
marilyn,1,0,0,1,0,0,2
website,0,1,0,1,0,0,2
humor,0,1,0,0,1,0,2
phillip,1,0,0,0,0,1,2
jeweler,1,0,0,0,0,1,2
shrimp,1,0,1,0,0,0,2
lucie,0,0,0,0,1,1,2
plaque,1,0,0,1,0,0,2
carbon,0,0,0,2,0,0,2
snowman,0,0,1,0,0,1,2
headache,0,0,0,0,0,2,2
observatory,0,1,0,1,0,0,2
bootlegging,1,0,0,0,0,1,2
isabella,0,0,0,1,1,0,2
individuality,0,0,1,0,0,1,2
rhetoric,0,1,1,0,0,0,2
breeze,0,0,1,1,0,0,2
rajkumar,0,2,0,0,0,0,2
abominable,0,0,1,0,0,1,2
rivendell,1,0,0,0,1,0,2
guillotine,0,0,0,0,1,1,2
vijaya,0,0,2,0,0,0,2
stein,1,0,0,0,0,1,2
knock,1,0,0,0,0,1,2
accomplishment,1,0,1,0,0,0,2
tribals,0,0,1,0,1,0,2
orlok,0,0,0,0,0,2,2
mausoleum,1,1,0,0,0,0,2
classic,0,0,1,1,0,0,2
bribery,1,0,0,0,1,0,2
running,0,0,0,1,0,1,2
manjula,0,2,0,0,0,0,2
rift,1,1,0,0,0,0,2
hermit,0,0,1,1,0,0,2
maharaja,0,0,2,0,0,0,2
conquistador,0,0,0,1,1,0,2
vizier,0,0,2,0,0,0,2
brace,2,0,0,0,0,0,2
dome,0,1,0,1,0,0,2
prix,0,0,0,1,1,0,2
venus,0,1,0,0,0,1,2
adam,0,0,0,1,0,1,2
kramer,0,0,0,1,0,1,2
rubik,0,0,0,1,0,1,2
sender,0,0,0,1,1,0,2
reserve,1,0,0,0,1,0,2
maternity,1,0,0,0,0,1,2
glimmer,1,0,1,0,0,0,2
heroism,0,0,0,0,1,1,2
rex,0,0,0,0,0,2,2
eavesdropping,1,0,0,1,0,0,2
chi,0,0,0,1,1,0,2
lyndon,1,0,0,0,0,1,2
unconsciousness,0,0,1,0,1,0,2
indiana,0,1,0,1,0,0,2
suave,0,0,1,1,0,0,2
screw,1,1,0,0,0,0,2
football,1,0,1,0,0,0,2
jones,0,1,0,0,0,1,2
researcher,0,1,0,1,0,0,2
awakens,0,0,0,0,0,2,2
monument,1,0,0,0,1,0,2
hai,1,0,0,0,1,0,2
opium,1,0,0,0,1,0,2
buford,1,0,0,1,0,0,2
limousine,1,0,0,1,0,0,2
pyramid,0,0,0,1,1,0,2
traitor,1,0,1,0,0,0,2
lighthouse,0,1,0,0,1,0,2
mount doom,1,0,0,0,1,0,2
workshop,0,1,0,0,0,1,2
bryant,1,1,0,0,0,0,2
revival,0,0,1,0,0,1,2
genie,0,0,1,1,0,0,2
insomnia,2,0,0,0,0,0,2
auschwitz,1,1,0,0,0,0,2
hubble,0,1,0,1,0,0,2
sarpanch,1,0,0,0,1,0,2
vagabond,1,0,0,0,1,0,2
fairy,0,0,0,0,0,2,2
ida,0,0,1,1,0,0,2
domain,0,0,0,1,1,0,2
ramshackle,0,0,1,0,0,1,2
aura,0,0,0,2,0,0,2
hose,0,0,2,0,0,0,2
boris,1,0,1,0,0,0,2
moria,1,0,0,0,1,0,2
cheating,0,0,1,0,1,0,2
offensive,1,0,0,1,0,0,2
tibetan,0,1,0,1,0,0,2
veronica,1,0,0,0,0,1,2
fyodor,1,0,0,1,0,0,2
twelve,0,0,0,0,1,1,2
fever,0,0,0,0,0,2,2
combination,0,0,0,1,0,1,2
inexperience,0,0,0,1,1,0,2
uruk-hai,1,0,0,0,1,0,2
rei,0,0,0,1,0,1,2
théâtre,1,0,0,0,0,1,2
philippe,0,0,0,1,0,1,2
crony,0,0,1,0,1,0,2
grown,0,1,0,0,1,0,2
cid,0,1,0,1,0,0,2
the red death,0,0,1,0,0,1,2
sing,0,0,0,0,1,1,2
samwise,1,0,0,0,1,0,2
hussein,0,2,0,0,0,0,2
successor,0,0,1,1,0,0,2
parking,0,1,0,1,0,0,2
misfit,0,1,0,1,0,0,2
arrogance,1,0,0,0,1,0,2
saroja,1,0,0,0,0,1,2
skating,0,1,0,0,0,1,2
specie,0,0,1,1,0,0,2
ringmaster,0,1,1,0,0,0,2
lucky,1,0,1,0,0,0,2
gym,0,0,0,1,1,0,2
overconfidence,0,0,0,1,1,0,2
ledge,0,0,0,1,1,0,2
eddie,0,0,0,0,1,1,2
petrol,0,0,0,1,1,0,2
hyun,0,0,0,1,0,1,2
probability,0,1,1,0,0,0,2
vidal,0,0,0,0,0,2,2
workers,1,0,0,1,0,0,2
jessica,0,0,0,0,1,1,2
feast,0,0,0,0,0,2,2
manure,0,0,1,1,0,0,2
debra,0,0,0,1,0,1,2
professional,0,1,0,0,1,0,2
baghdad,0,2,0,0,0,0,2
saddam,0,2,0,0,0,0,2
hooligan,0,1,0,0,1,0,2
children,1,0,1,0,0,0,2
eagle,1,0,0,0,0,1,2
vijaykanth,0,0,1,0,1,0,2
laws,0,1,0,1,0,0,2
hypocrisy,0,0,1,0,1,0,2
solar,0,0,0,2,0,0,2
rooming,1,0,1,0,0,0,2
marauder,0,0,0,1,0,1,2
nameless,1,0,0,0,1,0,2
le,1,0,0,1,0,0,2
bloody,0,0,0,0,1,1,2
azerbaijan,0,0,1,0,1,0,2
breakup,0,0,1,0,0,1,2
soap,1,0,0,0,0,1,2
frau,0,0,1,1,0,0,2
wehrmacht,2,0,0,0,0,0,2
divorce,0,0,1,1,0,0,2
acre,0,0,0,0,1,1,2
caribbean,0,0,0,0,1,1,2
du,1,0,0,1,0,0,2
blackout,1,0,0,0,0,1,2
forward,0,0,0,0,1,1,2
gardner,0,1,0,1,0,0,2
bloodline,0,0,0,1,0,1,2
receipt,1,0,0,0,1,0,2
absurdity,0,0,1,1,0,0,2
schlosser,0,1,0,1,0,0,2
orly,0,0,1,1,0,0,2
township,0,1,0,1,0,0,2
feed,0,0,0,0,1,1,2
mickey,0,1,0,0,1,0,2
mocking,0,0,0,1,1,0,2
spectacle,0,0,1,0,0,1,2
peak,0,1,1,0,0,0,2
simplicity,0,0,1,0,1,0,2
zurich,0,0,1,1,0,0,2
womanizer,1,0,0,0,1,0,2
publisher,0,0,1,0,1,0,2
swiss,0,0,0,1,1,0,2
motorbike,0,0,0,0,1,1,2
orchard,0,0,0,2,0,0,2
nunnery,0,1,0,1,0,0,2
salary,0,0,2,0,0,0,2
cue,0,0,2,0,0,0,2
edit,0,0,1,0,0,1,2
barker,1,0,0,0,0,1,2
jasmine,0,0,2,0,0,0,2
seema,0,1,1,0,0,0,2
smoking,0,0,0,0,1,1,2
violation,0,0,0,0,1,1,2
anjaneya,1,0,0,0,1,0,2
sisters,1,0,0,0,0,1,2
punk,0,0,1,1,0,0,2
spectator,1,1,0,0,0,0,2
bhupati,1,0,1,0,0,0,2
prophet,0,0,2,0,0,0,2
behest,2,0,0,0,0,0,2
aspiration,0,1,1,0,0,0,2
joliet,1,0,0,0,1,0,2
les,1,0,0,0,1,0,2
couch,0,0,0,0,0,2,2
happy,0,0,0,1,0,1,2
jackie,0,0,1,1,0,0,2
constraint,1,0,0,1,0,0,2
vendor,1,0,0,0,1,0,2
athlete,0,1,1,0,0,0,2
volcanic,0,1,0,0,1,0,2
sprint,0,1,0,1,0,0,2
venezuela,1,0,1,0,0,0,2
deliberation,0,1,0,0,1,0,2
steamroller,0,0,0,1,1,0,2
elves,1,0,0,0,1,0,2
piety,2,0,0,0,0,0,2
ruse,0,0,1,0,1,0,2
robotics,0,0,0,2,0,0,2
neighbouring,2,0,0,0,0,0,2
shrine,1,0,1,0,0,0,2
galadriel,1,0,0,0,1,0,2
ape,0,0,0,1,0,1,2
sabotage,1,0,0,1,0,0,2
gothic,0,0,0,0,0,2,2
symptom,0,0,1,1,0,0,2
insolence,1,0,0,0,1,0,2
starr,0,0,0,1,1,0,2
juror,0,1,0,0,0,1,2
celeborn,1,0,0,0,1,0,2
thrilling,1,0,1,0,0,0,2
developer,1,0,0,0,0,1,2
western,1,0,0,1,0,0,2
suryam,0,0,1,0,1,0,2
balrog,1,0,0,0,1,0,2
the fellowship of the ring,1,0,0,0,1,0,2
liberty,0,0,0,1,1,0,2
ugly,0,0,1,1,0,0,2
gaston,0,0,1,0,0,1,2
imagery,1,0,0,0,0,1,2
puja,0,0,1,0,1,0,2
troublemaker,0,1,0,0,1,0,2
surge,1,0,0,1,0,0,2
pradhan,0,1,0,0,1,0,2
stern,1,0,0,0,1,0,2
marijuana,1,0,0,0,0,1,2
oskar,1,0,0,0,0,1,2
grape,1,0,0,0,0,1,2
chick,1,0,0,0,0,1,2
ping,1,0,1,0,0,0,2
fellowship,1,0,0,0,1,0,2
cap,1,0,1,0,0,0,2
appetite,0,0,0,1,1,0,2
honour,0,0,1,1,0,0,2
ellie,1,0,1,0,0,0,2
vasundhara,0,0,1,0,1,0,2
alpha,1,0,0,1,0,0,2
february,0,1,1,0,0,0,2
mailbox,1,0,0,1,0,0,2
morgul,1,0,0,0,1,0,2
voting,0,1,0,0,0,1,2
retort,0,1,1,0,0,0,2
daimyo,1,0,0,0,1,0,2
mercedes,0,0,0,1,0,1,2
labour,1,0,0,0,0,1,2
mosquito,1,0,0,0,0,1,2
honesty,0,1,1,0,0,0,2
rajaguru,0,0,2,0,0,0,2
hiroshi,0,0,0,2,0,0,2
damien,0,0,0,0,0,2,2
shire,1,0,0,0,1,0,2
interim,1,0,1,0,0,0,2
deceit,0,2,0,0,0,0,2
pony,1,0,0,1,0,0,2
gamgee,1,0,0,0,1,0,2
bruise,0,0,0,0,0,2,2
marries,0,0,1,1,0,0,2
newcomer,0,0,0,0,1,1,2
near,0,0,1,1,0,0,2
waitress,1,0,1,0,0,0,2
offspring,0,0,1,1,0,0,2
suman,0,0,2,0,0,0,2
helena,0,0,1,0,0,1,2
pathologist,0,0,0,1,0,1,2
industries,0,0,0,0,1,1,2
birthmark,0,0,1,0,0,1,2
han,0,0,0,2,0,0,2
pre,0,1,0,0,0,1,2
dementia,0,0,1,1,0,0,2
sip,0,0,1,0,0,1,2
middleman,1,0,1,0,0,0,2
cradle,0,0,0,0,0,2,2
avenger,0,1,0,0,1,0,2
purse,0,0,0,0,0,2,2
shrew,1,0,0,1,0,0,2
complication,0,0,1,0,0,1,2
lone,0,0,0,1,1,0,2
management,0,0,1,0,0,1,2
scratch,0,0,0,0,0,2,2
sadist,0,1,0,1,0,0,2
isildur,1,0,0,0,1,0,2
uruk,1,0,0,0,1,0,2
vacuum,0,0,0,2,0,0,2
murthy,0,1,1,0,0,0,2
coven,0,0,0,0,0,2,2
musket,1,0,0,0,1,0,2
folly,0,0,2,0,0,0,2
miser,0,2,0,0,0,0,2
jadoo,0,0,1,1,0,0,2
gondola,1,0,0,0,0,1,2
medical,0,0,1,1,0,0,2
baggins,1,0,0,0,1,0,2
suraj,0,1,0,0,1,0,2
rajendra,1,1,0,0,0,0,2
achievement,1,0,0,0,1,0,2
haveli,0,1,1,0,0,0,2
insurgent,0,1,0,0,1,0,2
grade,1,0,1,0,0,0,2
seven,0,0,0,0,1,1,2
mama,0,0,1,0,1,0,2
analyst,0,1,0,0,1,0,2
blank,0,0,0,0,1,1,2
the first world war,0,1,0,0,1,0,2
st,0,1,0,0,1,0,2
mornay,0,0,0,0,1,1,2
scotland,0,0,0,0,1,1,2
e,0,0,1,1,0,0,2
nanny,0,0,1,0,0,1,2
unrest,0,0,0,0,1,1,2
fitzgerald,0,0,0,0,1,1,2
audio,0,1,0,0,0,1,2
monarch,0,1,0,0,0,1,2
exploitation,0,0,0,0,1,1,2
greg,1,1,0,0,0,0,2
1940s,0,1,1,0,0,0,2
loop,0,1,0,1,0,0,2
ten,0,0,0,0,1,1,2
sicilian,1,0,1,0,0,0,2
chagrin,0,0,1,0,1,0,2
armed,0,1,0,1,0,0,2
c.,0,1,1,0,0,0,2
logan,0,0,0,0,1,1,2
s.,0,1,0,0,1,0,2
josephine,0,0,1,0,1,0,2
mining,0,0,0,0,2,0,2
amnesty,0,0,0,0,2,0,2
schoolteacher,0,0,0,0,2,0,2
conference,0,0,1,0,1,0,2
ross,0,1,0,1,0,0,2
diplomat,0,1,0,0,1,0,2
phil,0,1,0,1,0,0,2
observer,0,1,1,0,0,0,2
can,0,0,1,0,1,0,2
accordance,0,1,1,0,0,0,2
telegraph,0,1,0,1,0,0,2
israeli,0,1,0,0,1,0,2
tryst,0,0,0,0,1,1,2
chore,0,1,1,0,0,0,2
caravan,0,0,0,0,2,0,2
freeway,0,0,1,0,1,0,2
racing,0,0,1,0,1,0,2
sen,0,0,1,1,0,0,2
annabelle,0,0,0,0,1,1,2
conductor,0,0,1,0,1,0,2
finish,0,0,1,1,0,0,2
arab,0,0,0,0,2,0,2
nightfall,0,0,0,0,1,1,2
converse,0,0,1,1,0,0,2
hms,0,0,0,0,2,0,2
boiler,0,0,1,0,0,1,2
believer,0,0,1,0,0,1,2
aztec,0,0,0,0,1,1,2
scholar,0,0,1,0,0,1,2
hillside,0,0,1,0,1,0,2
disability,0,0,1,1,0,0,2
pictures,0,0,2,0,0,0,2
mathematics,0,0,1,1,0,0,2
slug,0,0,1,1,0,0,2
johnnie,0,0,0,0,1,1,2
disregard,0,0,1,0,1,0,2
seal,0,0,1,0,0,1,2
ivy,0,0,1,1,0,0,2
away,0,0,2,0,0,0,2
cashier,0,0,1,0,0,1,2
lama,1,1,0,0,0,0,2
narasimha,0,0,2,0,0,0,2
bey,0,0,0,0,1,1,2
susuwatari,0,0,2,0,0,0,2
plain,0,0,0,0,1,1,2
tehran,0,0,2,0,0,0,2
placement,0,0,2,0,0,0,2
terrain,0,0,0,0,2,0,2
cobbler,0,0,1,1,0,0,2
northward,0,0,0,0,2,0,2
the confederate army,0,0,0,0,2,0,2
bathhouse,0,0,1,0,1,0,2
stink,0,0,1,0,0,1,2
sue,0,0,2,0,0,0,2
herman,0,1,0,0,1,0,2
compass,0,0,0,0,2,0,2
abortion,1,0,0,0,0,1,2
palanquin,0,0,0,0,2,0,2
treaty,0,1,0,0,1,0,2
malabar,0,1,0,0,0,1,2
whale,0,0,1,1,0,0,2
speak,0,0,1,1,0,0,2
syndrome,0,0,0,0,1,1,2
asset,0,0,0,0,2,0,2
pine,0,0,0,0,2,0,2
bubbles,0,0,1,1,0,0,2
over,0,0,1,0,1,0,2
decide,0,1,1,0,0,0,2
mirage,0,0,0,0,2,0,2
privilege,0,0,0,0,2,0,2
daddy,0,0,2,0,0,0,2
bathtub,1,0,0,0,0,1,2
ammu,0,1,0,0,1,0,2
siddharth,0,0,1,0,1,0,2
adversary,0,0,0,0,1,1,2
elliott,0,1,0,1,0,0,2
diver,0,0,1,1,0,0,2
eloquence,0,0,0,0,1,1,2
sympathy,0,1,1,0,0,0,2
nosebleed,0,0,1,1,0,0,2
reef,0,0,1,1,0,0,2
balakrishnan,0,1,0,0,0,1,2
nemo,0,0,1,1,0,0,2
jacques,0,0,1,0,0,1,2
innocent,0,1,0,0,1,0,2
reunite,0,0,1,0,1,0,2
curtis,0,2,0,0,0,0,2
gill,0,0,1,0,0,1,2
mr,0,1,0,1,0,0,2
ellis,2,0,0,0,0,0,2
landfill,0,2,0,0,0,0,2
net,0,0,1,0,1,0,2
diet,0,0,1,0,1,0,2
plastic,0,1,1,0,0,0,2
sunil,0,0,1,0,1,0,2
dasaradha,0,0,0,0,2,0,2
shantytown,0,1,0,0,0,1,2
fran,0,1,0,0,0,1,2
goodman,0,1,0,0,0,1,2
manning,0,1,0,0,0,1,2
flatmate,0,0,1,0,0,1,2
maxim,0,1,1,0,0,0,2
coolie,0,0,0,0,2,0,2
channel,0,1,0,0,1,0,2
adviser,0,0,1,0,1,0,2
yoko,0,0,0,0,1,1,2
ethan,0,1,0,0,1,0,2
mortgage,1,0,0,0,1,0,2
megan,0,0,1,1,0,0,2
wig,0,0,1,0,0,1,2
bass,0,0,1,1,0,0,2
build,0,1,0,1,0,0,2
zero,0,0,0,0,2,0,2
bryan,0,1,1,0,0,0,2
timeless,1,1,0,0,0,0,2
superstition,0,1,0,0,0,1,2
severs,0,0,0,0,2,0,2
riverside,0,0,1,0,1,0,2
segment,0,0,1,1,0,0,2
toronto,1,0,0,1,0,0,2
waste,0,0,1,1,0,0,2
chasm,0,0,1,0,0,1,2
keith,0,1,0,0,0,1,2
recollection,0,0,1,1,0,0,2
salisbury,0,0,0,0,1,1,2
aids,0,1,1,0,0,0,2
bloodbath,0,0,0,0,1,1,2
rogue,0,0,0,0,2,0,2
zhao,0,0,0,0,2,0,2
refrigerator,0,1,0,0,0,1,2
manu,0,1,0,0,0,1,2
alzheimer,0,1,1,0,0,0,2
restraint,0,0,0,0,1,1,2
beating,0,0,0,0,2,0,2
whole,0,0,1,0,0,1,2
classroom,0,0,1,0,0,1,2
four,0,0,0,0,1,1,2
enterprises,2,0,0,0,0,0,2
dacoit,0,0,1,0,1,0,2
democracy,0,0,2,0,0,0,2
courtesy,0,0,0,0,2,0,2
clap,0,0,1,1,0,0,2
gotham,2,0,0,0,0,0,2
valance,0,0,0,0,2,0,2
nora,0,0,0,0,1,1,2
billboard,0,0,1,1,0,0,2
masterji,0,0,2,0,0,0,2
moonlight,0,0,0,0,2,0,2
kilometer,0,0,0,0,2,0,2
umbrella,0,0,2,0,0,0,2
jog,0,0,1,0,1,0,2
searching,0,0,1,1,0,0,2
manhunt,2,0,0,0,0,0,2
gautam,0,0,1,0,1,0,2
indication,0,0,1,1,0,0,2
drought,0,0,2,0,0,0,2
dissolute,0,0,1,0,1,0,2
rainbow,0,0,1,1,0,0,2
faisal,1,0,0,0,1,0,2
forgery,0,0,1,0,1,0,2
gita,0,0,2,0,0,0,2
earnings,0,0,1,0,0,1,2
globe,0,0,1,1,0,0,2
rosie,0,0,1,0,1,0,2
hate,0,0,1,0,1,0,2
bhola,0,0,2,0,0,0,2
batman,2,0,0,0,0,0,2
neighboring,0,0,2,0,0,0,2
incidence,0,0,1,0,1,0,2
dent,2,0,0,0,0,0,2
denizen,0,0,0,0,1,1,2
wagner,0,0,1,0,0,1,2
superintendent,0,0,0,0,2,0,2
dispatch,0,0,1,0,0,1,2
deposit,0,0,2,0,0,0,2
blythe,0,0,0,0,1,1,2
dilemma,0,0,2,0,0,0,2
caveman,0,0,1,1,0,0,2
auguste,0,0,2,0,0,0,2
roam,0,0,2,0,0,0,2
soldiers,0,0,0,0,1,1,2
groggy,0,0,0,0,1,1,2
agua,0,0,0,0,2,0,2
lots,0,0,1,0,0,1,2
withdrawal,0,0,1,1,0,0,2
tile,0,0,1,0,1,0,2
woody,0,0,2,0,0,0,2
concierge,0,0,1,0,0,1,2
buzz,0,0,2,0,0,0,2
lightyear,0,0,2,0,0,0,2
ken,0,0,1,1,0,0,2
eulogy,1,0,1,0,0,0,2
jennings,0,0,0,0,1,1,2
sid,0,0,2,0,0,0,2
radiator,0,0,1,1,0,0,2
reconnaissance,0,0,1,0,1,0,2
memorabilia,0,0,1,1,0,0,2
improvise,0,0,1,0,0,1,2
vice,0,0,1,0,1,0,2
haggard,0,0,1,1,0,0,2
michigan,0,0,1,0,0,1,2
follow,0,0,0,0,2,0,2
founder,0,0,1,0,0,1,2
wandering,0,0,0,0,1,1,2
singin,0,0,1,1,0,0,2
kathy,0,0,2,0,0,0,2
expectation,0,0,1,0,0,1,2
optimism,0,0,1,0,1,0,2
pull,0,0,1,0,1,0,2
discrimination,0,0,2,0,0,0,2
bartlett,0,0,0,0,1,1,2
scripture,0,0,1,0,1,0,2
indo,0,0,0,0,2,0,2
sedgwick,0,0,0,0,2,0,2
pick,0,0,0,0,2,0,2
ito,0,0,0,0,1,1,2
drift,0,0,1,1,0,0,2
overture,0,0,2,0,0,0,2
sadhu,0,0,1,0,1,0,2
coleman,2,0,0,0,0,0,2
wednesday,0,0,0,0,2,0,2
horn,0,0,1,0,1,0,2
healing,0,0,1,0,1,0,2
believe,0,0,1,1,0,0,2
ferry,1,0,0,0,1,0,2
stampede,0,0,1,0,1,0,2
seriousness,0,0,0,0,2,0,2
swarm,0,0,1,0,0,1,2
tenement,1,0,0,0,1,0,2
militant,0,0,0,0,2,0,2
viking,0,0,2,0,0,0,2
silhouette,0,0,1,0,1,0,2
kasi,0,0,0,0,2,0,2
siegfried,0,0,1,0,1,0,2
schoolgirl,0,0,0,0,2,0,2
wise,0,0,1,0,0,1,2
latter,0,0,0,0,1,1,2
mathew,0,0,0,0,1,1,2
gillian,1,0,0,1,0,0,2
bala,0,0,2,0,0,0,2
predecessor,0,0,1,0,1,0,2
bark,0,0,1,1,0,0,2
adolescent,1,0,0,0,1,0,2
gaming,1,0,0,0,1,0,2
rs,0,0,1,0,1,0,2
marx,0,0,2,0,0,0,2
sage,0,0,2,0,0,0,2
atheist,0,0,1,0,0,1,2
magistrate,0,0,1,0,1,0,2
rip,0,0,1,0,0,1,2
bugs,0,0,2,0,0,0,2
offscreen,0,0,1,0,0,1,2
blizzard,0,0,0,0,2,0,2
fencing,0,0,1,0,0,1,2
dish,0,0,1,1,0,0,2
federales,0,0,0,0,2,0,2
senate,2,0,0,0,0,0,2
kabbadi,0,0,0,0,2,0,2
lands,0,0,1,0,1,0,2
opposite,0,0,2,0,0,0,2
sal,1,1,0,0,0,0,2
moustache,0,0,2,0,0,0,2
consul,0,0,0,0,1,1,2
mix,0,0,1,0,0,1,2
standing,0,0,0,0,2,0,2
acquisition,0,0,0,0,1,1,2
inventory,0,0,0,0,1,1,2
usage,0,0,1,1,0,0,2
murugan,0,0,2,0,0,0,2
warehouse,0,0,0,0,1,1,2
beak,1,0,1,0,0,0,2
scabbard,0,0,0,0,2,0,2
d'costa,0,0,2,0,0,0,2
socialite,0,0,2,0,0,0,2
prowess,0,0,0,0,2,0,2
pennyworth,2,0,0,0,0,0,2
mishap,0,0,2,0,0,0,2
motor,0,0,1,1,0,0,2
cuba,1,1,0,0,0,0,2
tournament-,0,0,0,0,2,0,2
the national league,0,0,0,0,2,0,2
lorry,0,0,0,0,2,0,2
specter,0,0,1,0,0,1,2
kabaddi,0,0,0,0,2,0,2
priya,0,0,1,0,1,0,2
donor,0,0,1,0,0,1,2
floodlight,0,0,0,0,2,0,2
romantic,0,0,1,1,0,0,2
dawes,2,0,0,0,0,0,2
melancholy,0,0,1,1,0,0,2
idealism,1,0,1,0,0,0,2
nanda,0,0,0,0,2,0,2
crucifixion,0,0,0,0,2,0,2
kurta,0,0,2,0,0,0,2
hassan,0,0,2,0,0,0,2
resolution,0,0,1,0,0,1,2
skirt,0,0,1,0,1,0,2
mus,0,0,0,0,1,1,2
fortification,0,0,0,0,2,0,2
handful,0,0,1,1,0,0,2
trophy,1,0,1,0,0,0,2
swapna,0,0,1,0,1,0,2
kaasi,0,0,1,0,1,0,2
curly,0,0,0,0,2,0,2
absentee,0,1,0,0,1,0,2
dinosaur,0,0,0,1,0,1,2
pilgrimage,0,0,2,0,0,0,2
victoria,0,0,1,0,1,0,2
snack,1,0,0,1,0,0,2
carlos,0,1,0,0,0,1,2
marie,0,2,0,0,0,0,2
corral,0,0,0,0,1,1,2
vignette,0,2,0,0,0,0,2
snap,0,1,1,0,0,0,2
powell,0,0,1,1,0,0,2
ringo,0,0,0,0,2,0,2
plummet,0,1,0,0,0,1,2
notebook,0,0,0,1,0,1,2
gunslinger,0,0,0,0,1,1,2
iraqi,0,2,0,0,0,0,2
sinclair,0,1,0,0,0,1,2
malhotra,0,0,2,0,0,0,2
meteor,0,0,0,1,1,0,2
newscaster,0,1,0,1,0,0,2
crater,0,0,0,1,1,0,2
veterinarian,0,0,0,0,1,1,2
sanjay,0,0,1,1,0,0,2
homer,0,0,0,0,1,1,2
partnership,0,0,0,1,1,0,2
paan,0,0,1,0,1,0,2
ratan,0,0,1,0,1,0,2
firearm,0,0,0,0,2,0,2
iran,0,1,1,0,0,0,2
dictatorship,0,1,1,0,0,0,2
waist,0,0,0,0,2,0,2
the gulf war,0,2,0,0,0,0,2
north india,0,0,1,0,1,0,2
expertise,1,0,1,0,0,0,2
interviewer,0,0,0,0,2,0,2
helpmann,0,0,1,1,0,0,2
toto,0,0,1,1,0,0,2
carelessness,0,0,0,1,1,0,2
spin,0,0,1,0,0,1,2
raya,0,2,0,0,0,0,2
daze,0,1,1,0,0,0,2
raman,0,1,1,0,0,0,2
krishnadeva,0,2,0,0,0,0,2
howling,0,0,0,0,1,1,2
dorothy,0,0,1,0,1,0,2
bouncer,0,0,1,0,1,0,2
wright,0,1,1,0,0,0,2
twister,0,0,1,0,0,1,2
pulp,1,0,0,1,0,0,2
entourage,0,0,0,0,1,1,2
ruby,0,0,2,0,0,0,2
burton,0,0,0,1,1,0,2
cherry,0,0,0,1,1,0,2
gujarat,0,0,2,0,0,0,2
ivory,0,1,0,0,0,1,2
harmony,0,1,0,0,0,1,2
gunpowder,0,0,0,1,0,1,2
butch,1,0,0,0,1,0,2
hug,0,1,1,0,0,0,2
uma,0,1,0,0,0,1,2
postman,0,1,0,0,1,0,2
dispose,1,0,0,1,0,0,2
carla,0,0,0,1,0,1,2
edinburgh,0,0,0,1,1,0,2
chester,0,1,0,0,0,1,2
under,0,1,0,0,0,1,2
valuable,1,0,0,0,1,0,2
soiree,0,1,1,0,0,0,2
total,0,0,1,0,1,0,2
gut,0,1,1,0,0,0,2
beverage,0,1,1,0,0,0,2
philadelphia,0,1,0,0,0,1,2
jar,0,0,0,0,1,1,2
rug,1,0,1,0,0,0,2
incinerator,0,1,1,0,0,0,2
roadside,0,1,0,0,1,0,2
er,0,0,0,0,1,1,2
sanctuary,0,0,0,1,0,1,2
assailant,0,0,0,0,1,1,2
annoyance,0,1,1,0,0,0,2
junkyard,1,0,0,1,0,0,2
rudolf,1,1,0,0,0,0,2
contest,1,0,0,0,0,1,2
the final solution,1,1,0,0,0,0,2
hire,0,0,0,0,1,1,2
proxy,0,0,0,1,0,1,2
landowner,0,2,0,0,0,0,2
thevar,0,1,0,0,1,0,2
jules,1,0,0,1,0,0,2
matthew,0,0,0,1,1,0,2
redemption,1,1,0,0,0,0,2
kill,0,1,0,0,0,1,2
hers,0,0,2,0,0,0,2
olympic,0,1,0,1,0,0,2
icon,2,0,0,0,0,0,2
vishnu,0,1,1,0,0,0,2
scholarship,2,0,0,0,0,0,2
similarity,0,1,0,1,0,0,2
miriam,0,1,0,0,1,0,2
alligator,0,0,1,0,0,1,2
martínez,0,1,0,0,1,0,2
amon,1,0,0,0,0,1,2
morse,0,0,0,1,0,1,2
shade,0,0,0,1,1,0,2
vox,0,1,0,1,0,0,2
crossfire,0,0,1,0,1,0,2
tunisia,0,2,0,0,0,0,2
mines,1,0,0,0,1,0,2
jaguar,0,0,0,0,1,1,2
osborn,0,1,0,1,0,0,2
raider,0,0,0,0,2,0,2
monoxide,0,0,0,2,0,0,2
atlantic,0,0,0,1,1,0,2
trajectory,0,1,0,1,0,0,2
syllable,0,0,1,1,0,0,2
odyssey,0,1,0,1,0,0,2
medalist,0,1,0,1,0,0,2
european,0,1,0,0,1,0,2
preethi,0,1,1,0,0,0,2
recommendation,0,1,1,0,0,0,2
drinker,0,0,0,0,1,1,2
vasudevan,0,2,0,0,0,0,2
cremation,0,2,0,0,0,0,2
northern,0,0,0,0,1,1,2
veeran,0,0,2,0,0,0,2
accolade,0,0,1,1,0,0,2
armstrong,0,0,0,0,1,1,2
the red army,2,0,0,0,0,0,2
the nazi party,1,0,0,0,1,0,2
trainer,0,0,0,0,1,1,2
karthik,0,0,1,1,0,0,2
bud,0,0,1,1,0,0,2
memories,0,1,0,1,0,0,2
mackenzie,2,0,0,0,0,0,2
rajasthan,0,0,1,0,1,0,2
splinter,1,1,0,0,0,0,2
diana,0,1,1,0,0,0,2
seaside,0,1,0,0,0,1,2
smell,0,0,1,0,0,1,2
gloucester,0,1,0,0,1,0,2
olson,0,1,0,1,0,0,2
furnace,0,0,0,1,0,1,2
blanche,0,0,1,0,0,1,2
banks,0,1,0,0,1,0,2
zed,1,0,0,1,0,0,2
skinner,0,0,1,0,1,0,2
poland,2,0,0,0,0,0,2
luftwaffe,0,1,0,0,1,0,2
alfredo,0,0,1,0,0,1,2
catacomb,0,0,0,1,0,1,2
commences,1,0,0,0,1,0,2
roar,0,0,1,1,0,0,2
peril,0,0,0,1,1,0,2
hollow,0,0,1,0,0,1,2
nerd,0,0,0,1,0,1,2
pie,0,0,0,1,0,1,2
ronald,0,2,0,0,0,0,2
pinch,0,1,0,0,1,0,2
synopsis,0,1,0,0,1,0,2
pier,0,1,0,0,0,1,2
lifeboat,0,0,0,0,2,0,2
brutality,0,1,1,0,0,0,2
titanic,0,0,0,0,2,0,2
the iraq war,0,2,0,0,0,0,2
righteousness,0,1,1,0,0,0,2
media,1,1,0,0,0,0,2
leprosy,0,1,0,0,1,0,2
booby,0,0,0,0,1,1,2
thornton,0,0,0,0,1,1,2
leper,0,1,0,0,1,0,2
adultery,0,1,1,0,0,0,2
vow,0,1,0,0,1,0,2
climb,0,0,1,0,1,0,2
expand,0,1,0,1,0,0,2
craig,0,1,0,1,0,0,2
arch,0,0,0,0,2,0,2
stevens,0,0,0,0,1,1,2
allegation,0,1,0,0,1,0,2
chez,0,0,0,0,1,1,2
karan,0,0,1,0,1,0,2
helplessness,0,0,0,0,2,0,2
cadillac,0,0,0,0,2,0,2
ensemble,1,0,0,0,0,1,2
sethu,0,0,0,0,2,0,2
boys,0,0,0,0,2,0,2
faust,0,1,0,0,0,1,2
carpathia,0,0,0,0,2,0,2
dot,0,1,0,1,0,0,2
compartment,0,0,0,0,1,1,2
sinking,0,0,0,0,2,0,2
seaman,0,0,0,0,1,1,2
rms,0,0,0,0,2,0,2
denver,0,1,0,0,1,0,2
pablo,0,0,0,0,1,1,2
iceberg,0,0,0,0,2,0,2
dehydration,0,0,0,0,1,1,2
rio,0,0,0,0,2,0,2
participation,0,0,1,0,1,0,2
molly,0,1,0,0,1,0,2
withdraws,0,0,1,0,0,1,2
pakistanis,0,0,0,0,2,0,2
airline,0,0,1,1,0,0,2
joint,1,0,0,0,1,0,2
georgia,0,0,1,0,1,0,2
miscarriage,1,0,0,1,0,0,2
ivan,0,0,0,0,1,1,2
heiress,0,0,1,0,1,0,2
pant,0,1,0,0,0,1,2
iowa,0,1,0,1,0,0,2
burglary,1,1,0,0,0,0,2
ashok,0,1,0,0,1,0,2
westley,0,0,2,0,0,0,2
meena,0,1,1,0,0,0,2
harmonica,0,1,0,0,1,0,2
woe,0,1,0,0,1,0,2
dwelling,0,1,1,0,0,0,2
guruji,0,1,1,0,0,0,2
mohini,0,1,1,0,0,0,2
rebirth,0,0,0,1,1,0,2
elsa,0,0,1,0,0,1,2
messenger,0,0,1,0,1,0,2
indonesia,0,1,0,0,0,1,2
choir,0,0,1,0,1,0,2
defender,0,0,0,0,2,0,2
coil,0,0,2,0,0,0,2
laurie,0,1,0,0,1,0,2
kurt,0,0,1,0,0,1,2
paltry,0,1,1,0,0,0,2
mockumentary,0,1,1,0,0,0,2
rupee,0,2,0,0,0,0,2
srivastava,0,1,1,0,0,0,2
drum,0,1,0,0,0,1,2
choreography,0,0,2,0,0,0,2
armour,0,0,0,0,1,1,2
declaration,0,0,0,0,1,1,2
goat,0,1,1,0,0,0,2
county,0,0,0,0,2,0,2
guardsmen,0,0,0,0,1,1,2
lovett,0,0,0,0,1,1,2
indifference,0,1,0,0,1,0,2
lounge,1,0,0,0,1,0,2
income,0,1,0,0,1,0,2
georgie,0,1,0,1,0,0,2
ruth,0,0,0,0,1,1,2
hypothermia,0,0,0,0,1,1,2
aires,0,1,0,1,0,0,2
counsel,1,0,0,0,1,0,2
weeks,0,0,0,1,1,0,2
liz,0,0,0,1,0,1,2
candlelight,0,0,0,1,1,0,2
muthu,0,1,0,0,1,0,2
foursome,0,1,0,0,1,0,2
liar,0,0,0,0,1,1,2
dissent,1,0,0,0,1,0,2
the east coast,0,0,0,1,0,1,2
motorist,0,0,0,1,1,0,2
narada,0,0,1,1,0,0,2
carousel,0,2,0,0,0,0,2
walker,0,1,0,0,0,1,2
swordfight,0,0,0,0,1,1,2
new mexico,0,1,0,0,1,0,2
fragment,0,0,0,1,0,1,2
botanist,0,1,0,1,0,0,2
foreigner,0,1,0,1,0,0,2
ramu,0,2,0,0,0,0,2
soundtrack,0,1,0,1,0,0,2
jung,0,0,0,0,1,1,2
new orleans,0,1,0,0,1,0,2
token,0,0,1,0,1,0,2
scoring,0,1,0,0,0,1,2
native americans,0,1,0,0,1,0,2
orleans,0,1,0,0,1,0,2
terrier,0,0,1,0,1,0,2
schooner,0,0,0,0,1,1,2
aaron,0,1,0,0,1,0,2
terrill,0,0,0,0,2,0,2
kasthuri,0,0,2,0,0,0,2
sphinx,0,1,0,1,0,0,2
crook,0,1,1,0,0,0,2
pork,0,2,0,0,0,0,2
bonnie,1,0,1,0,0,0,2
flush,1,1,0,0,0,0,2
rohan,0,0,0,0,2,0,2
adaptation,0,2,0,0,0,0,2
chopper,2,0,0,0,0,0,2
heating,0,1,0,1,0,0,2
faramir,0,0,0,0,2,0,2
hungary,0,1,0,0,0,1,2
edoras,0,0,0,0,2,0,2
brass,0,1,0,0,0,1,2
aslam,0,0,2,0,0,0,2
verge,0,0,0,0,2,0,2
canadian,1,0,0,0,0,1,2
jailer,0,0,1,1,0,0,2
maxwell,0,0,0,0,1,1,2
osgiliath,0,0,0,0,2,0,2
rohirrim,0,0,0,0,2,0,2
t,2,0,0,0,0,0,2
éowyn,0,0,0,0,2,0,2
lawlessness,0,0,0,0,2,0,2
escapade,0,1,1,0,0,0,2
vendetta,0,0,0,0,1,1,2
nagesh,0,1,1,0,0,0,2
singapore,0,0,1,1,0,0,2
malaysia,0,1,0,0,1,0,2
nirmala,0,1,1,0,0,0,2
reincarnation,0,0,0,0,1,1,2
ceo,0,1,1,0,0,0,2
treebeard,0,0,0,0,2,0,2
théoden,0,0,0,0,2,0,2
aravind,0,1,1,0,0,0,2
crack,0,0,0,0,2,0,2
danube,0,1,1,0,0,0,2
éomer,0,0,0,0,2,0,2
overrun,0,0,0,0,1,1,2
terminal,1,0,1,0,0,0,2
miguel,0,0,0,0,1,1,2
coronation,0,0,1,0,1,0,2
tak,0,0,0,2,0,0,2
colonial,2,0,0,0,0,0,2
siu,0,0,0,0,0,2,2
supreme,2,0,0,0,0,0,2
stasis,1,0,0,1,0,0,2
yin,0,0,0,0,0,2,2
spinster,1,0,0,0,0,1,2
nuclear,1,0,0,1,0,0,2
mummy,0,0,0,0,0,2,2
urn,0,0,0,0,0,2,2
airlock,1,0,0,1,0,0,2
cleaner,1,0,0,1,0,0,2
transmitter,1,0,0,0,1,0,2
central america,0,0,0,2,0,0,2
streak,0,0,0,0,0,2,2
recognizes,1,0,0,0,1,0,2
loader,1,0,0,1,0,0,2
poncho,0,0,0,1,1,0,2
carter,1,0,0,0,1,0,2
ripley,1,0,0,1,0,0,2
burke,1,0,0,0,0,1,2
gear,1,0,0,1,0,0,2
skepticism,1,0,0,1,0,0,2
onboard,0,0,0,2,0,0,2
orderly,1,0,0,0,0,1,2
orchestra,0,0,0,1,0,1,2
mafioso,2,0,0,0,0,0,2
wong,0,0,0,1,0,1,2
marble,1,0,0,0,0,1,2
aliens,1,0,1,0,0,0,2
nostromo,1,0,0,1,0,0,2
refinery,0,0,0,2,0,0,2
n,1,0,0,0,0,1,2
gutter,1,1,0,0,0,0,2
cinder,1,0,0,1,0,0,2
syringe,0,0,0,0,0,2,2
assurance,1,0,0,1,0,0,2
tramp,1,0,0,0,0,1,2
daydream,0,0,1,1,0,0,2
rhythm,0,0,1,0,1,0,2
czechoslovakia,0,0,1,0,0,1,2
nonsense,1,0,0,0,1,0,2
wan,0,0,0,2,0,0,2
gustav,0,0,0,1,0,1,2
chow,0,0,0,1,1,0,2
potion,0,0,0,0,0,2,2
ning,0,0,0,0,0,2,2
dallas,0,0,0,1,1,0,2
pin,1,0,0,0,0,1,2
thermonuclear,1,0,0,1,0,0,2
ramirez,0,0,0,1,1,0,2
dea,1,0,0,0,0,1,2
appeal,1,1,0,0,0,0,2
speculates,0,0,0,1,1,0,2
hive,1,0,0,1,0,0,2
refer,0,0,0,1,0,1,2
resurrection,0,0,0,2,0,0,2
servitude,0,0,0,0,0,2,2
choi,0,0,0,0,0,2,2
embryo,1,0,0,1,0,0,2
counselor,1,0,0,0,0,1,2
smother,1,0,0,0,0,1,2
overseer,2,0,0,0,0,0,2
insulin,1,0,0,0,0,1,2
fritz,0,0,0,1,0,1,2
remade,1,0,0,0,1,0,2
executioner,0,0,0,1,1,0,2
r.,0,0,0,1,1,0,2
porter,0,0,0,1,0,1,2
magnus,0,0,0,1,0,1,2
ludovico,0,0,0,1,0,1,2
pr,0,0,0,1,0,1,2
stare,0,0,0,1,1,0,2
hypnosis,0,0,0,2,0,0,2
shriek,0,0,0,1,0,1,2
grandchild,0,0,0,1,0,1,2
extraterrestrial,0,0,0,2,0,0,2
g.,1,1,0,0,0,0,2
paranoid,1,0,0,1,0,0,2
bhanumathi,1,0,0,0,1,0,2
polaroid,1,0,0,0,0,1,2
fu,0,0,0,0,0,2,2
eyelid,0,0,0,1,0,1,2
bess,0,0,0,1,1,0,2
uhura,0,0,0,2,0,0,2
occult,0,0,0,0,0,2,2
intimacy,1,0,1,0,0,0,2
lamb,1,0,0,0,0,1,2
clemenza,2,0,0,0,0,0,2
sammy,1,0,0,1,0,0,2
hindrance,1,0,1,0,0,0,2
pint,0,0,0,2,0,0,2
ruckus,1,0,0,0,1,0,2
kate,0,0,0,0,0,2,2
pretense,1,0,1,0,0,0,2
windmill,0,0,0,1,0,1,2
disk,0,0,0,2,0,0,2
seoul,1,0,0,1,0,0,2
su,1,0,0,1,0,0,2
capacitor,0,0,0,2,0,0,2
captivity,1,0,0,1,0,0,2
the warsaw ghetto,1,1,0,0,0,0,2
ronin,1,0,0,0,1,0,2
li,0,0,0,1,1,0,2
nomination,0,0,0,1,1,0,2
dae,1,0,0,0,0,1,2
garb,0,0,0,1,0,1,2
bolt,0,0,0,2,0,0,2
campus,0,0,0,0,0,2,2
maggot,0,0,0,0,0,2,2
setup,0,0,0,2,0,0,2
stock,2,0,0,0,0,0,2
the black room,0,0,0,0,0,2,2
flux,0,0,0,2,0,0,2
the old west,0,0,0,1,0,1,2
kingo,2,0,0,0,0,0,2
discontent,0,0,0,2,0,0,2
bamboo,1,0,0,0,1,0,2
raquel,2,0,0,0,0,0,2
guitarist,0,0,0,1,1,0,2
blaster,0,0,0,2,0,0,2
warsaw,1,1,0,0,0,0,2
treblinka,1,1,0,0,0,0,2
penny,0,0,1,1,0,0,2
oregon,2,0,0,0,0,0,2
hardens,1,0,0,1,0,0,2
kyle,2,0,0,0,0,0,2
sentinel,1,1,0,0,0,0,2
emergence,1,0,1,0,0,0,2
mandy,1,0,1,0,0,0,2
salzburg,1,0,1,0,0,0,2
fed,0,0,0,0,0,2,2
firehouse,0,0,0,1,0,1,2
holy,1,0,0,0,0,1,2
manufacturer,0,0,0,1,1,0,2
leopold,1,0,0,0,1,0,2
peck,0,0,0,2,0,0,2
sighting,0,0,0,2,0,0,2
renfield,0,0,0,0,0,2,2
converge,1,0,0,1,0,0,2
gamble,1,1,0,0,0,0,2
chat,1,0,0,0,0,1,2
in,0,0,0,1,0,1,2
harker,0,0,0,0,0,2,2
nail,0,0,0,0,0,2,2
clark,0,0,0,1,0,1,2
lens,1,1,0,0,0,0,2
doyle,2,0,0,0,0,0,2
lisa,1,0,0,0,0,1,2
detonator,1,0,0,1,0,0,2
antenna,0,0,0,2,0,0,2
wilhelm,1,0,0,0,0,1,2
thompson,0,0,0,1,0,1,2
donny,1,0,1,0,0,0,2
premiere,1,0,1,0,0,0,2
component,1,0,0,0,0,1,2
arctic,0,0,0,2,0,0,2
sentient,1,0,0,1,0,0,2
duke,0,0,1,0,0,1,2
confirmation,1,0,0,1,0,0,2
flint,0,0,0,1,1,0,2
tube,1,0,0,1,0,0,2
reel,2,0,0,0,0,0,2
pittsburgh,1,1,0,0,0,0,2
mast,0,0,0,1,1,0,2
sedgewick,0,0,0,1,1,0,2
hanger,0,0,0,1,0,1,2
columbia,0,0,0,1,0,1,2
increase,1,0,0,0,1,0,2
schoolmate,0,0,1,0,0,1,2
archbishop,1,1,0,0,0,0,2
smuggler,1,0,1,0,0,0,2
vat,1,0,0,0,0,1,2
communicates,1,0,1,0,0,0,2
fracture,1,0,1,0,0,0,2
freeze,0,0,0,0,0,2,2
mascot,0,0,0,2,0,0,2
andreas,0,0,0,1,0,1,2
beloved,1,0,1,0,0,0,2
janet,0,0,0,0,0,2,2
maggie,1,0,0,1,0,0,2
yorkers,0,0,0,1,0,1,2
pauper,1,0,0,0,0,1,2
strait,2,0,0,0,0,0,2
breaking,0,0,0,1,0,1,2
susan,1,0,0,0,0,1,2
saying,1,1,0,0,0,0,2
ma,1,0,0,0,0,1,2
blunderbuss,0,0,0,1,1,0,2
riddle,1,0,0,1,0,0,2
persuasion,1,0,0,0,1,0,2
gum,1,0,0,0,0,1,2
rack,0,0,1,0,1,0,2
bounce,0,0,1,0,1,0,2
rear,0,0,1,1,0,0,2
ethic,1,0,0,0,1,0,2
monroe,1,0,0,1,0,0,2
ramp,0,0,1,1,0,0,2
sd,1,0,0,0,1,0,2
closeness,0,0,1,0,1,0,2
ernie,1,0,0,0,0,1,2
rand,0,0,0,0,0,2,2
dreyfus,1,1,0,0,0,0,2
citizenship,1,0,0,0,1,0,2
the house of lords,0,0,1,0,0,1,2
martini,2,0,0,0,0,0,2
wage,0,0,1,0,1,0,2
benefactor,1,0,0,0,0,1,2
harding,1,0,0,0,0,1,2
fatigue,1,0,0,0,1,0,2
sandy,0,0,0,2,0,0,2
narayan,1,0,1,0,0,0,2
touch,1,0,1,0,0,0,2
czech,0,0,1,1,0,0,2
predicament,0,0,0,0,0,2,2
friday,1,0,0,1,0,0,2
potter,1,1,0,0,0,0,2
cruise,2,0,0,0,0,0,2
firefight,1,0,0,0,1,0,2
accent,1,0,0,1,0,0,2
smash,0,0,1,0,1,0,2
accord,0,0,1,0,0,1,2
edith,0,0,1,1,0,0,2
haunting,0,0,0,1,0,1,2
excerpt,1,0,0,1,0,0,2
sturmbannführer,1,0,0,0,1,0,2
omar,1,0,0,0,1,0,2
transfusion,0,0,0,0,0,2,2
excitement,0,0,0,0,0,2,2
agents,2,0,0,0,0,0,2
handing,1,0,0,0,0,1,2
ant,0,0,0,2,0,0,2
coroner,0,0,0,1,0,1,2
marcel,1,0,0,1,0,0,2
harold,0,0,0,1,1,0,2
hank,0,0,0,0,0,2,2
lords,0,0,1,0,0,1,2
new yorkers,0,0,0,1,0,1,2
original,0,0,1,0,1,0,2
textbook,0,0,0,1,0,1,2
lars,1,0,0,0,1,0,2
stella,1,0,0,1,0,0,2
gruber,0,0,0,2,0,0,2
buddha,0,0,0,1,1,0,2
clip,1,0,0,1,0,0,2
applaud,1,0,0,0,1,0,2
flashbulb,1,0,0,0,0,1,2
displacement,1,0,0,1,0,0,2
sewage,1,0,0,1,0,0,2
clarice,1,0,0,1,0,0,2
hurt,1,1,0,0,0,0,2
gorbachev,1,1,0,0,0,0,2
interrogation,0,0,0,1,1,0,2
reaper,0,0,0,0,0,2,2
detonate,1,0,0,1,0,0,2
lionel,1,0,1,0,0,0,2
jill,0,0,0,1,1,0,2
prop,1,0,0,1,0,0,2
minefield,0,0,0,1,1,0,2
crematorium,1,0,0,1,0,0,2
impotence,0,0,0,0,0,2,2
printer,0,0,0,2,0,0,2
fluid,1,0,0,0,0,1,2
sophistication,1,0,1,0,0,0,2
belle,1,0,1,0,0,0,2
serbian,2,0,0,0,0,0,2
submission,0,0,0,1,1,0,2
banner,0,0,0,2,0,0,2
1990s,2,0,0,0,0,0,2
fore,1,0,1,0,0,0,2
ridicule,1,0,0,1,0,0,2
delusion,0,0,0,1,1,0,2
extra,1,0,0,0,0,1,2
1950s,1,0,0,0,0,1,2
archibald,0,0,0,1,1,0,2
arif,0,0,0,1,1,0,2
fifth,0,0,0,1,1,0,2
brotherhood,2,0,0,0,0,0,2
newsreel,1,1,0,0,0,0,2
avengers,0,0,0,2,0,0,2
jay,1,0,0,0,0,1,2
patrolling,1,0,1,0,0,0,2
potential,0,0,0,1,1,0,2
u.s. army,1,0,0,0,1,0,2
legion,1,0,0,0,0,1,2
deterrent,1,0,0,1,0,0,2
en,0,0,0,1,0,1,2
velu,1,0,0,0,1,0,2
motivation,1,0,0,0,0,1,2
housekeeper,0,0,0,1,1,0,2
countryman,0,0,0,1,1,0,2
solicitor,0,0,0,1,0,1,2
brigadier,1,0,0,1,0,0,2
psychopath,0,0,0,0,0,2,2
madras,1,0,1,0,0,0,2
premier,1,1,0,0,0,0,2
open,1,0,0,0,0,1,2
thread,1,0,0,0,1,0,2
detonation,1,0,0,1,0,0,2
brandon,0,0,0,1,1,0,2
luka,2,0,0,0,0,0,2
kalpana,1,0,1,0,0,0,2
webber,0,0,0,1,0,1,2
serbs,1,0,0,0,1,0,2
carpenter,0,0,0,1,1,0,2
capo,2,0,0,0,0,0,2
chalk,0,0,0,0,0,2,2
figurehead,0,0,0,1,0,1,2
timing,0,0,0,2,0,0,2
raf,1,0,0,0,1,0,2
stamen,0,0,0,1,0,1,2
gore,0,0,0,1,0,1,2
serb,1,0,0,0,1,0,2
camouflage,1,0,0,1,0,0,2
communicator,0,0,0,2,0,0,2
valkyries,1,0,1,0,0,0,2
gossip,1,0,0,0,0,1,2
lesbian,0,0,0,0,0,2,2
outcast,0,0,0,0,0,2,2
serum,0,0,0,2,0,0,2
tentacle,0,0,0,2,0,0,2
l.,1,1,0,0,0,0,2
bodybuilder,1,1,0,0,0,0,2
intervention,0,0,0,1,1,0,2
puranam,1,0,1,0,0,0,2
platter,0,0,0,0,0,2,2
carlo,2,0,0,0,0,0,2
bioweapon,0,0,0,2,0,0,2
dna,0,0,0,1,0,1,2
shoes,1,0,1,0,0,0,2
bulk,0,0,0,1,0,1,2
saxophonist,0,0,0,1,1,0,2
tessio,2,0,0,0,0,0,2
creditor,1,0,0,0,0,1,2
upstream,1,0,0,0,1,0,2
takashi,0,0,0,2,0,0,2
trucker,1,0,0,0,0,1,2
willard,1,0,0,0,0,1,2
backwoods,0,0,0,0,0,2,2
capability,0,0,0,1,0,1,2
jeopardy,1,1,0,0,0,0,2
luna,0,0,0,2,0,0,2
cultist,0,0,0,0,0,2,2
loyalist,2,0,0,0,0,0,2
playboy,1,0,0,1,0,0,2
salute,1,0,0,0,1,0,2
airstrike,1,1,0,0,0,0,2
savitri,1,0,1,0,0,0,2
helene,1,0,0,1,0,0,2
cyrus,0,0,0,0,0,2,2
saigon,1,0,0,1,0,0,2
alight,1,0,0,0,0,1,2
belgrade,1,1,0,0,0,0,2
speedy,1,1,0,0,0,0,2
fredo,2,0,0,0,0,0,2
kelvin,0,0,0,2,0,0,2
spawn,0,0,0,1,0,1,2
evacuation,0,0,0,1,1,0,2
bosniak,1,0,0,0,1,0,2
cordon,0,0,0,1,1,0,2
yugoslavia,1,1,0,0,0,0,2
manhattan,0,0,0,2,0,0,2
egyptian,0,0,0,0,0,2,2
fetus,0,0,0,2,0,0,2
roxanne,0,0,0,1,1,0,2
a bosnian serb,1,0,0,0,1,0,2
dowry,1,1,0,0,0,0,2
hicks,2,0,0,0,0,0,2
nikola,2,0,0,0,0,0,2
fingernail,0,0,0,1,0,1,2
slip,0,0,0,1,0,1,2
recruitment,1,1,0,0,0,0,2
muller,0,0,0,0,0,2,2
interceptor,0,0,0,1,1,0,2
surfing,1,0,0,1,0,0,2
warder,0,0,0,1,1,0,2
underwater,0,0,0,1,1,0,2
breakout,1,0,0,0,1,0,2
knot,1,0,1,0,0,0,2
maker,0,0,0,0,0,2,2
julia,1,0,0,0,1,0,2
beam,0,0,0,2,0,0,2
joan,0,0,0,0,0,2,2
teleportation,1,0,0,0,0,1,2
christopher,0,0,0,2,0,0,2
georg,1,0,1,0,0,0,2
checkpoint,1,0,0,0,1,0,2
prestige,1,0,1,0,0,0,2
floorboard,2,0,0,0,0,0,2
condolence,1,0,1,0,0,0,2
titan,0,0,0,2,0,0,2
tiberius,0,0,0,1,1,0,2
delta,0,0,0,1,0,1,2
norm,1,0,1,0,0,0,2
angle,1,0,0,0,0,1,2
triangle,1,0,0,1,0,0,2
broadcasting,0,0,0,2,0,0,2
sylvia,0,0,0,1,0,1,2
tailor,1,0,0,0,1,0,2
respite,0,0,0,2,0,0,2
laali,1,0,0,0,1,0,2
financing,1,0,0,0,1,0,2
gallery,0,0,0,1,0,1,2
sulu,0,0,0,2,0,0,2
paratrooper,1,0,0,0,1,0,2
awakening,0,0,0,0,0,2,2
ohio,1,0,0,0,0,1,2
hangar,0,0,0,2,0,0,2
paramedic,0,0,0,1,0,1,2
typewriter,1,0,0,0,0,1,2
stalk,1,0,0,1,0,0,2
cottage,0,0,0,0,0,2,2
mikhail,1,1,0,0,0,0,2
downstairs,0,0,0,0,0,2,2
springs,1,0,0,0,1,0,2
milton,1,0,0,0,0,1,2
scam,2,0,0,0,0,0,2
toughness,1,0,0,0,0,1,2
refuse,1,1,0,0,0,0,2
vulcan,0,0,0,2,0,0,2
sonny,2,0,0,0,0,0,2
liaison,1,0,0,1,0,0,2
duplicate,1,0,0,1,0,0,2
conspirator,1,0,0,0,1,0,2
technician,0,0,0,2,0,0,2
bookstore,1,0,1,0,0,0,2
bewilderment,0,0,0,1,0,1,2
receptionist,0,0,0,1,0,1,2
spendthrift,2,0,0,0,0,0,2
memphis,1,0,0,0,1,0,2
howard,0,0,0,1,1,0,2
disadvantage,0,0,0,2,0,0,2
addiction,1,1,0,0,0,0,2
klingon,0,0,0,2,0,0,2
quo,1,0,0,1,0,0,2
plunge,1,0,0,1,0,0,2
advertisement,1,0,0,0,0,1,2
arc,0,0,0,2,0,0,2
waiting,0,0,0,1,0,1,2
smear,1,0,0,0,0,1,2
corleones,2,0,0,0,0,0,2
kent,0,0,0,2,0,0,2
flora,0,0,0,1,0,1,2
firepower,0,0,0,1,1,0,2
lucifer,0,0,0,0,0,2,2
shaving,0,0,0,1,0,1,2
dug,2,0,0,0,0,0,2
bandage,0,0,0,1,1,0,2
insane,1,0,0,0,0,1,2
urging,0,0,0,1,1,0,2
iceland,0,0,0,2,0,0,2
enforcement,1,0,0,0,1,0,2
laden,1,0,0,0,0,1,2
ryoko,0,0,0,1,0,1,2
nsa,1,0,0,1,0,0,2
new jersey,1,0,0,1,0,0,2
parachute,1,0,1,0,0,0,2
gps,1,0,0,1,0,0,2
sesame,0,0,0,2,0,0,2
dignity,0,0,0,0,0,2,2
geyser,0,0,0,1,0,1,2
secretariat,1,1,0,0,0,0,2
maureen,0,0,0,1,0,1,2
taxidermy,0,0,0,0,0,2,2
counterpart,0,0,0,2,0,0,2
casualty,2,0,0,0,0,0,2
ownership,0,0,0,1,1,0,2
manpower,1,0,0,0,1,0,2
bosnia,1,0,0,0,1,0,2
sham,1,0,1,0,0,0,2
outsider,1,0,1,0,0,0,2
brar,2,0,0,0,0,0,2
organisation,1,0,0,1,0,0,2
sardar,1,1,0,0,0,0,2
rabbi,2,0,0,0,0,0,2
olivia,1,1,0,0,0,0,2
sore,0,0,0,1,0,1,2
seclusion,1,0,1,0,0,0,2
mccoy,0,0,0,2,0,0,2
lever,0,0,0,1,0,1,2
samet,1,0,1,0,0,0,2
bystander,1,0,0,0,1,0,2
friction,1,0,1,0,0,0,2
shield,0,0,0,2,0,0,2
physic,0,0,0,1,1,0,2
pencil,0,0,0,1,0,1,2
sri lanka,1,1,0,0,0,0,2
nautilus,0,0,0,2,0,0,2
damnation,0,0,0,0,0,2,2
superman,0,0,0,2,0,0,2
hikaru,0,0,0,2,0,0,2
stack,0,0,0,2,0,0,2
mainland,0,0,0,1,0,1,2
masse,0,0,0,0,0,2,2
vegetation,0,0,0,1,0,1,2
walkie,0,0,0,1,1,0,2
jersey,1,0,0,1,0,0,2
figaro,2,0,0,0,0,0,2
lanka,1,1,0,0,0,0,2
collide,0,0,0,2,0,0,2
firing,1,0,0,1,0,0,2
warring,1,0,0,0,1,0,2
kyoto,1,0,0,0,1,0,2
winslow,0,0,1,1,0,0,2
whistle,1,0,1,0,0,0,2
tango,1,0,1,0,0,0,2
chalice,0,0,1,0,0,1,2
pontius,0,0,1,0,1,0,2
pillai,0,0,1,0,1,0,2
necronomicon,0,0,0,0,0,2,2
boost,0,0,0,1,0,1,2
reasoning,1,0,0,0,1,0,2
oldsmobile,0,0,0,0,0,2,2
traveller,0,0,0,1,1,0,2
calloway,0,0,1,0,1,0,2
nazareth,0,0,1,0,1,0,2
tsunami,1,0,0,1,0,0,2
turks,0,0,0,1,1,0,2
pledge,1,1,0,0,0,0,2
anju,1,1,0,0,0,0,2
taro,1,0,0,0,0,1,2
palo,1,0,1,0,0,0,2
tractor,0,0,0,1,0,1,2
clause,1,0,0,0,0,1,2
edo,2,0,0,0,0,0,2
flashbacks,1,0,0,0,1,0,2
antagonist,1,0,0,1,0,0,2
ufos,0,0,0,1,0,1,2
victorian,0,0,0,1,0,1,2
vanity,1,1,0,0,0,0,2
extractor,1,0,1,0,0,0,2
cyborg,0,0,0,2,0,0,2
outage,0,0,0,1,1,0,2
stony,1,0,0,1,0,0,2
disintegrator,0,0,0,2,0,0,2
apologizes,1,0,0,0,1,0,2
united nations,0,0,0,1,1,0,2
farmhand,0,0,1,0,1,0,2
subbulakshmi,1,0,1,0,0,0,2
lunatic,0,0,0,0,0,2,2
kalyani,1,1,0,0,0,0,2
lamont,1,0,1,0,0,0,2
arjun,1,0,1,0,0,0,2
ante,1,0,0,0,1,0,2
destroyer,1,0,0,1,0,0,2
yamato,0,0,0,2,0,0,2
harbour,1,0,1,0,0,0,2
collaborator,1,0,0,0,1,0,2
newlywed,1,1,0,0,0,0,2
raoul,0,0,0,0,0,2,2
salvage,0,0,0,1,1,0,2
pilate,0,0,1,0,1,0,2
organism,0,0,0,1,0,1,2
phobia,0,0,0,0,0,2,2
vito,2,0,0,0,0,0,2
initiate,1,0,0,0,0,1,2
complete,0,0,1,0,1,0,2
extract,1,0,0,0,0,1,2
tormentor,0,0,0,0,0,2,2
angered,0,0,0,1,0,1,2
judean,0,0,1,0,1,0,2
1960s,1,1,0,0,0,0,2
bidding,0,0,0,1,0,1,2
irish-american,2,0,0,0,0,0,2
ease,1,0,0,0,1,0,2
stipulation,1,0,0,0,0,1,2
romans,0,0,1,0,1,0,2
chagny,0,0,0,0,0,2,2
dev,0,0,1,0,1,0,2
virginity,1,0,0,0,0,1,2
luxury,1,0,0,1,0,0,2
mortis,0,0,0,0,0,2,2
astronaut,0,0,0,2,0,0,2
hull,0,0,0,2,0,0,2
new york state,2,0,0,0,0,0,2
new guinea,0,0,0,2,0,0,2
ned,1,0,0,1,0,0,2
jing,0,0,1,1,0,0,2
cadaver,0,0,0,1,0,1,2
barton,1,0,0,1,0,0,2
deadite,0,0,0,0,0,2,2
bunker,1,0,0,0,1,0,2
animation,0,0,0,1,0,1,2
caution,1,0,0,1,0,0,2
bright,0,0,1,1,0,0,2
triumphant,0,0,0,0,0,2,2
armless,0,0,0,0,0,2,2
sakthi,1,0,1,0,0,0,2
bread,1,0,0,0,0,1,2
powers,1,0,1,0,0,0,2
rukmani,1,0,1,0,0,0,2
restoration,1,0,0,0,1,0,2
administration,1,0,0,0,0,1,2
avalanche,1,0,0,0,1,0,2
merit,2,0,0,0,0,0,2
kutty,1,0,0,0,1,0,2
coming,0,0,1,1,0,0,2
fitzgibbons,1,0,0,1,0,0,2
ias,1,1,0,0,0,0,2
oliver,1,0,0,1,0,0,2
extinction,0,0,0,1,0,1,2
mole,1,0,0,0,0,1,2
ridge,2,0,0,0,0,0,2
probation,1,0,0,1,0,0,2
credibility,1,0,1,0,0,0,2
envelope,1,0,1,0,0,0,2
spinning,1,1,0,0,0,0,2
ham,1,0,0,1,0,0,2
vatican,1,0,0,0,0,1,2
twilight,1,0,0,0,1,0,2
wax,1,0,0,0,0,1,2
lime,1,0,0,0,1,0,2
cd,2,0,0,0,0,0,2
impulse,0,0,0,1,0,1,2
godfather,2,0,0,0,0,0,2
conman,2,0,0,0,0,0,2
mist,0,0,0,1,1,0,2
gorilla,0,0,0,1,0,1,2
inquisition,1,0,0,1,0,0,2
warp,0,0,0,1,0,1,2
slice,0,0,0,1,1,0,2
heresy,1,0,0,1,0,0,2
dreamer,1,0,0,0,1,0,2
sedative,1,0,0,0,0,1,2
five,2,0,0,0,0,0,2
detention,1,0,0,0,1,0,2
eyesight,1,0,1,0,0,0,2
scrounger,0,0,0,1,1,0,2
leo,0,0,0,2,0,0,2
notion,2,0,0,0,0,0,2
colin,1,0,0,0,1,0,2
masquerade,0,0,0,1,0,1,2
pearson,0,0,0,1,0,1,2
robinson,1,0,0,1,0,0,2
extraction,1,0,0,1,0,0,2
generosity,1,0,0,0,1,0,2
rolfe,1,0,1,0,0,0,2
connie,2,0,0,0,0,0,2
stanton,1,0,0,0,1,0,2
sedation,1,0,0,1,0,0,2
django,1,0,1,0,0,0,2
victorian london,0,0,0,1,0,1,2
transit,1,0,0,0,0,1,2
manju,1,1,0,0,0,0,2
green,1,0,0,1,0,0,2
selfishness,1,0,1,0,0,0,2
navajo,1,0,0,0,1,0,2
revathi,1,1,0,0,0,0,2
feeding,1,0,0,0,0,1,2
downtown,2,0,0,0,0,0,2
paddy,1,0,0,0,1,0,2
ufo,0,0,0,2,0,0,2
wyoming,0,0,0,1,1,0,2
nursing,1,0,0,0,0,1,2
tribunal,1,0,0,0,1,0,2
browning,1,0,0,0,1,0,2
saito,2,0,0,0,0,0,2
greene,1,0,0,0,1,0,2
corleone,2,0,0,0,0,0,2
finch,1,1,0,0,0,0,2
schultz,1,0,1,0,0,0,2
tell,0,0,0,2,0,0,2
malfunction,1,0,0,1,0,0,2
appreciation,1,0,0,0,1,0,2
percy,1,0,0,0,1,0,2
mina,0,0,0,1,0,1,2
boo,1,0,1,0,0,0,2
assembly,1,0,1,0,0,0,2
devils,0,0,0,1,1,0,2
mothership,0,0,0,2,0,0,2
mutant,0,0,0,0,0,2,2
louise,1,0,0,1,0,0,2
robin,0,0,1,0,1,0,2
espionage,1,0,0,1,0,0,2
strongman,0,0,0,1,0,1,2
antidote,0,0,0,1,1,0,2
holdup,1,0,0,0,1,0,2
iv,0,0,0,2,0,0,2
beg,0,0,0,1,0,1,2
adams,1,0,0,1,0,0,2
chandelier,0,0,0,0,0,2,2
brides,0,0,0,0,0,2,2
antichrist,0,0,0,0,0,2,2
contractor,1,1,0,0,0,0,2
anthill,1,1,0,0,0,0,2
brow,0,0,0,1,0,1,2
stretcher,1,0,0,0,0,1,2
bones,0,0,0,1,1,0,2
north africa,1,0,0,0,1,0,2
notoriety,1,0,0,0,1,0,2
archer,1,0,0,1,0,0,2
pump,0,0,0,0,0,2,2
*,1,0,0,1,0,0,2
summary,2,0,0,0,0,0,2
govindan,1,0,0,0,1,0,2
grâce,1,0,1,0,0,0,2
carlotta,0,0,0,0,0,2,2
the pacific ocean,0,0,0,1,1,0,2
liner,1,0,1,0,0,0,2
rein,1,0,0,0,1,0,2
meenakshi,1,0,1,0,0,0,2
mayan,0,0,0,1,1,0,2
chariot,1,0,0,0,1,0,2
rationalist,0,0,0,0,0,2,2
mobility,1,0,0,0,0,1,2
dystopia,0,0,0,2,0,0,2
meekly,1,0,1,0,0,0,2
impossibility,1,1,0,0,0,0,2
gravestone,0,0,0,0,0,2,2
sporting,0,0,0,1,1,0,2
bubba,1,0,0,0,0,1,2
circumstances,1,1,0,0,0,0,2
fodder,0,0,0,2,0,0,2
hip,1,0,0,0,0,1,2
info,0,0,1,0,1,0,2
cicero,2,0,0,0,0,0,2
somu,1,0,0,0,1,0,2
practitioner,1,1,0,0,0,0,2
wrong,1,0,0,0,1,0,2
vito corleone,2,0,0,0,0,0,2
menon,1,1,0,0,0,0,2
marathon,1,0,0,1,0,0,2
zama,1,0,0,0,1,0,2
idealist,1,0,0,1,0,0,2
bearer,1,1,0,0,0,0,2
shanku,1,0,0,0,1,0,2
bookie,2,0,0,0,0,0,2
herbert,0,0,0,1,0,1,2
firefly,1,0,0,1,0,0,2
carrot,1,0,0,1,0,0,2
booking,1,0,0,0,1,0,2
fax,0,0,0,2,0,0,2
grid,0,0,0,2,0,0,2
jailor,0,0,1,0,1,0,2
needles,0,0,0,2,0,0,2
irving,0,0,0,1,0,1,2
mad,0,0,0,1,1,0,2
navigator,1,0,0,1,0,0,2
beard,0,0,0,2,0,0,2
judea,0,0,1,0,1,0,2
trafficking,1,0,0,0,1,0,2
animosity,0,0,0,1,1,0,2
disarray,0,0,0,1,1,0,2
greatness,1,1,0,0,0,0,2
safe,0,0,0,2,0,0,2
gladiator,1,0,0,0,1,0,2
sermon,0,0,1,0,1,0,2
homage,1,0,1,0,0,0,2
suite,0,0,0,0,0,2,2
quintus,1,0,0,0,1,0,2
new zealand,1,0,0,1,0,0,2
weekly,1,1,0,0,0,0,2
kimono,1,0,0,0,1,0,2
curb,1,0,1,0,0,0,2
mein,2,0,0,0,0,0,2
derek,1,0,1,0,0,0,2
judy,0,0,0,0,0,2,2
cannibal,0,0,0,1,0,1,2
entertainer,1,0,1,0,0,0,2
maximus,1,0,1,0,0,0,2
quantity,1,0,0,0,1,0,2
mansaku,0,0,0,1,0,0,1
trouser,0,0,0,0,1,0,1
the neutral zone,0,0,0,0,1,0,1
ostrow,0,0,0,1,0,0,1
bitch,0,0,0,0,1,0,1
flt,0,0,0,0,1,0,1
tighten,0,0,0,1,0,0,1
ritchi,0,0,0,1,0,0,1
barricade,0,0,0,0,1,0,1
carson,0,0,0,0,1,0,1
retro,0,0,0,1,0,0,1
rowboat,0,0,0,0,1,0,1
stratagem,0,0,0,0,1,0,1
theirs,0,0,0,1,0,0,1
shichirōji,0,0,0,0,1,0,1
curator,0,0,0,1,0,0,1
millet,0,0,0,0,1,0,1
yohei,0,0,0,0,1,0,1
revel,0,0,0,1,0,0,1
tuco,0,0,0,0,1,0,1
heihachi,0,0,0,0,1,0,1
truckloads,0,0,0,0,1,0,1
dufresne,1,0,0,0,0,0,1
relatives&nbsp,0,0,0,1,0,0,1
metro city,0,0,0,1,0,0,1
boins,0,0,0,1,0,0,1
kikuchiyo,0,0,0,0,1,0,1
natsuki,0,0,0,1,0,0,1
hyper,0,0,0,1,0,0,1
king kazma,0,0,0,1,0,0,1
shino,0,0,0,0,1,0,1
claustrophobia,0,0,0,0,1,0,1
rikichi,0,0,0,0,1,0,1
metro city's,0,0,0,1,0,0,1
educator,0,0,0,1,0,0,1
funky,0,0,0,1,0,0,1
moat,0,0,0,0,1,0,1
prodding,0,0,0,0,1,0,1
macdonald,0,0,0,0,1,0,1
megamind,0,0,0,1,0,0,1
katsushirō,0,0,0,0,1,0,1
rika,0,0,0,1,0,0,1
supervillian,0,0,0,1,0,0,1
koi,0,0,0,1,0,0,1
shawshank state penitentiary,1,0,0,0,0,0,1
c57,0,0,0,1,0,0,1
the swiss-border,0,0,0,0,1,0,1
gender,0,0,0,1,0,0,1
ammachi,0,0,0,0,1,0,1
appukkuttan,0,0,0,0,1,0,1
androse,0,0,0,0,1,0,1
parameshwaran,0,0,0,0,1,0,1
parthenogenesis,0,0,0,1,0,0,1
haidrose,0,0,0,0,1,0,1
keerikkadan,0,0,0,0,1,0,1
sedu,0,0,0,0,1,0,1
kazma,0,0,0,1,0,0,1
keshu,0,0,0,0,1,0,1
mahadevan,0,0,0,0,1,0,1
the police verification report,0,0,0,0,1,0,1
mahadevan's,0,0,0,0,1,0,1
sarodee,0,0,0,0,1,0,1
redline,0,0,0,1,0,0,1
stuhr,0,0,0,1,0,0,1
shota,0,0,0,1,0,0,1
apparatchik,0,0,0,1,0,0,1
olgierd,0,0,0,1,0,0,1
naia,0,0,0,1,0,0,1
androse's,0,0,0,0,1,0,1
veers,0,0,0,1,0,0,1
harihar,0,0,0,0,1,0,1
feminist,0,0,0,1,0,0,1
contraband,0,0,0,0,1,0,1
thenni,0,0,0,0,1,0,1
moderator,0,0,0,1,0,0,1
lalah,0,0,0,1,0,0,1
kenji,0,0,0,1,0,0,1
stride,0,0,0,0,1,0,1
rekha'who,0,0,0,0,1,0,1
appukuttan,0,0,0,0,1,0,1
frisbee,0,0,0,1,0,0,1
achuthan,0,0,0,0,1,0,1
sethumadhavan,0,0,0,0,1,0,1
nagar,0,0,0,0,1,0,1
otherworld,0,0,0,1,0,0,1
subjection,0,0,0,1,0,0,1
shinohara,0,0,0,1,0,0,1
machinehead,0,0,0,1,0,0,1
superhero,0,0,0,1,0,0,1
jose,0,0,0,0,1,0,1
sakae,0,0,0,1,0,0,1
viswanatha,0,0,0,0,1,0,1
eric,0,0,0,0,1,0,1
dickes,0,0,0,0,1,0,1
nayak,0,0,0,0,1,0,1
neutral,0,0,0,0,1,0,1
masterless,0,0,0,0,1,0,1
barzini,1,0,0,0,0,0,1
kyūzō,0,0,0,0,1,0,1
nbsp,0,0,0,1,0,0,1
katayama,0,0,0,0,1,0,1
racecar,0,0,0,1,0,0,1
velinski,0,0,0,0,1,0,1
ramapuram,0,0,0,0,1,0,1
bellerophon,0,0,0,1,0,0,1
gori,0,0,0,1,0,0,1
briefcase',0,0,0,0,1,0,1
paranna,0,0,0,0,1,0,1
marannu,0,0,0,0,1,0,1
confront,0,0,0,1,0,0,1
jester,0,0,0,0,1,0,1
rajabhakti towards srikrishnadevaraya,0,0,0,0,1,0,1
krishnan nair,0,0,0,0,1,0,1
ramanan,0,0,0,0,1,0,1
holding,0,0,0,0,1,0,1
thinna,0,0,0,0,1,0,1
granduncle,0,0,0,1,0,0,1
ganymede,0,0,0,1,0,0,1
rajabhakti,0,0,0,0,1,0,1
srikrishnadevaraya,0,0,0,0,1,0,1
tool,0,0,0,0,1,0,1
teams,0,0,0,0,1,0,1
kanker,0,0,0,0,1,0,1
fray,0,0,0,1,0,0,1
gandalf the white,0,0,0,0,1,0,1
nsea,0,0,0,1,0,0,1
the mines of moria,0,0,0,0,1,0,1
usaaf,0,0,0,0,1,0,1
gambit,0,0,0,1,0,0,1
steamlight,0,0,0,1,0,0,1
saruman's warg,0,0,0,0,1,0,1
beryllium,0,0,0,1,0,0,1
luger,0,0,0,0,1,0,1
saruman the white,0,0,0,0,1,0,1
demarco,0,0,0,1,0,0,1
galaxy quests,0,0,0,1,0,0,1
ion,0,0,0,1,0,0,1
explosives,0,0,0,0,1,0,1
blondie,0,0,0,0,1,0,1
defiance,0,0,0,1,0,0,1
ives,0,0,0,0,1,0,1
hendley,0,0,0,0,1,0,1
pitt,0,0,0,0,1,0,1
laliari,0,0,0,1,0,0,1
audiences,0,0,0,1,0,0,1
warg,0,0,0,0,1,0,1
orthanc,0,0,0,0,1,0,1
nesmith,0,0,0,1,0,0,1
surveyor,0,0,0,0,1,0,1
sentry,0,0,0,1,0,0,1
avatar,0,0,0,1,0,0,1
fangorn forest,0,0,0,0,1,0,1
thermians,0,0,0,1,0,0,1
jinnouchi,0,0,0,1,0,0,1
haynes,0,0,0,0,1,0,1
marshes,0,0,0,0,1,0,1
thermian,0,0,0,1,0,0,1
quinn,0,0,0,1,0,0,1
organizer,0,0,0,0,1,0,1
roc,0,0,0,1,0,0,1
the galaxy quest,0,0,0,1,0,0,1
ingersol,0,0,0,1,0,0,1
fearing,0,0,0,0,1,0,1
cannonball,0,0,0,0,1,0,1
ethos,0,0,0,1,0,0,1
"adams, morbius",0,0,0,1,0,0,1
dane,0,0,0,1,0,0,1
tottery,0,0,0,0,1,0,1
sad,0,0,0,0,1,0,1
cavendish,0,0,0,0,1,0,1
generators,0,0,0,1,0,0,1
farman,0,0,0,1,0,0,1
helm's deep,0,0,0,0,1,0,1
km,0,0,0,1,0,0,1
sad hill,0,0,0,0,1,0,1
fleegman,0,0,0,1,0,0,1
morbius,0,0,0,1,0,0,1
humanoid,0,0,0,1,0,0,1
the united planets,0,0,0,1,0,0,1
marker,0,0,0,0,1,0,1
robby,0,0,0,1,0,0,1
union sergeant,0,0,0,0,1,0,1
hey,0,0,0,0,1,0,1
abandon,0,0,0,0,1,0,1
krell,0,0,0,1,0,0,1
installation,0,0,0,1,0,0,1
helm,0,0,0,0,1,0,1
weakness,0,0,0,0,1,0,1
theoden,0,0,0,0,1,0,1
kwan,0,0,0,1,0,0,1
gwen,0,0,0,1,0,0,1
gandalf the grey,0,0,0,0,1,0,1
brego,0,0,0,0,1,0,1
mathesar,0,0,0,1,0,0,1
altaira,0,0,0,1,0,0,1
galaxy quest,0,0,0,1,0,0,1
huorn,0,0,0,0,1,0,1
"rangers of ithilien, frodo reveals gollum's",0,0,0,0,1,0,1
dividing,0,0,0,0,1,0,1
wormtongue,0,0,0,0,1,0,1
théodred,0,0,0,0,1,0,1
linguist,0,0,0,1,0,0,1
slumber,0,0,0,1,0,0,1
baltic,0,0,0,0,1,0,1
russian mob boss,0,0,0,0,1,0,1
ikezawa,0,0,0,1,0,0,1
moonshiner,0,0,0,0,1,0,1
blunder,0,0,0,0,1,0,1
prequel,0,0,0,0,1,0,1
swedish,0,0,0,0,1,0,1
congestion,0,0,0,1,0,0,1
chasing,0,0,0,0,1,0,1
anywhere,0,0,0,0,1,0,1
shota jinnouchi &,0,0,0,1,0,0,1
beggers,0,0,0,0,1,0,1
rhea,0,0,0,0,1,0,1
ashley,0,0,0,0,1,0,1
chaitanya,0,0,0,0,1,0,1
dhadar,0,0,0,0,1,0,1
quests,0,0,0,1,0,0,1
sebasstian,0,0,0,0,1,0,1
owners-,0,0,0,0,1,0,1
downriver,0,0,0,0,1,0,1
supercomputer,0,0,0,1,0,0,1
love machine,0,0,0,1,0,0,1
kambei,0,0,0,0,1,0,1
gorobei,0,0,0,0,1,0,1
arch stanton's,0,0,0,0,1,0,1
the united states armed forces,0,0,0,1,0,0,1
programming,0,0,0,1,0,0,1
yellowline,0,0,0,1,0,0,1
girls,0,0,0,0,1,0,1
seattlite,0,0,0,0,1,0,1
coolant,0,0,0,1,0,0,1
drag,0,0,0,0,1,0,1
milldues,0,0,0,0,1,0,1
forge,0,0,0,0,1,0,1
cooler,0,0,0,0,1,0,1
viswas,0,0,0,0,1,0,1
jinnouchis,0,0,0,1,0,0,1
infrastructure,0,0,0,1,0,0,1
planets,0,0,0,1,0,0,1
ents,0,0,0,0,1,0,1
group capt,0,0,0,0,1,0,1
kazuma,0,0,0,1,0,0,1
omega,0,0,0,1,0,0,1
dunland,0,0,0,0,1,0,1
gestapo,0,0,0,0,1,0,1
heatstroke,0,0,0,0,1,0,1
ramsey,0,0,0,0,1,0,1
senoshee,0,0,0,1,0,0,1
nebulizer,0,0,0,1,0,0,1
funky boy,0,0,0,1,0,0,1
jp,0,0,0,1,0,0,1
eyes,0,0,0,0,1,0,1
sweden,0,0,0,0,1,0,1
altair,0,0,0,1,0,0,1
ithilien,0,0,0,0,1,0,1
kuhn,0,0,0,0,1,0,1
uruk-hai army,0,0,0,0,1,0,1
redline mothership,0,0,0,1,0,0,1
denis,0,0,0,0,1,0,1
celebrate,0,0,0,1,0,0,1
handover,0,0,0,0,1,0,1
amit,0,0,0,0,1,0,1
pows,0,0,0,0,1,0,1
sakuma,0,0,0,1,0,0,1
hanafuda,0,0,0,1,0,0,1
sarris,0,0,0,1,0,0,1
escapee,0,0,0,0,1,0,1
viswa,0,0,0,0,1,0,1
hilts,0,0,0,0,1,0,1
the black gate,0,0,0,0,1,0,1
fraction,0,0,0,1,0,0,1
koiso,0,0,0,1,0,0,1
fangorn,0,0,0,0,1,0,1
gríma,0,0,0,0,1,0,1
dersu and captain arseniev,0,0,0,0,1,0,1
purana,0,0,0,0,1,0,1
arawashi,0,0,0,1,0,0,1
am,0,0,0,0,1,0,1
west coast,0,0,0,1,0,0,1
mutation,0,0,0,1,0,0,1
crossing,0,0,0,0,1,0,1
crore,0,0,0,0,1,0,1
auda,0,0,0,0,1,0,1
telekinetic,0,0,0,1,0,0,1
farraj,0,0,0,0,1,0,1
camel,0,0,0,0,1,0,1
presentation,0,0,0,0,1,0,1
conservation,0,0,0,0,1,0,1
apocalypse,0,0,0,0,1,0,1
skyscraper,0,0,0,0,1,0,1
guild,0,0,0,1,0,0,1
digit,0,0,0,1,0,0,1
siva,0,0,0,0,1,0,1
marcello,0,0,0,1,0,0,1
guards,0,0,0,1,0,0,1
basarlapudi,0,0,0,0,1,0,1
the gat men,0,0,0,1,0,0,1
pokyo,0,0,0,0,1,0,1
cbi,0,0,0,0,1,0,1
distaste,0,0,0,1,0,0,1
sollozzo,1,0,0,0,0,0,1
sinai,0,0,0,0,1,0,1
the ruling council,0,0,0,1,0,0,1
denree,0,0,0,1,0,0,1
paraman,0,0,0,0,1,0,1
mercenary,0,0,0,0,1,0,1
relish,0,0,0,0,1,0,1
kents,0,0,0,1,0,0,1
jor-el,0,0,0,1,0,0,1
ursa,0,0,0,1,0,0,1
dumka,0,0,0,0,1,0,1
barslapudi,0,0,0,0,1,0,1
british army,0,0,0,0,1,0,1
damascus,0,0,0,0,1,0,1
rig,0,0,0,1,0,0,1
miette,0,0,0,1,0,0,1
hackensack,0,0,0,1,0,0,1
pardhu,0,0,0,0,1,0,1
teschmacher,0,0,0,1,0,0,1
smallville,0,0,0,1,0,0,1
octopus,0,0,0,1,0,0,1
krank,0,0,0,1,0,0,1
zod,0,0,0,1,0,0,1
anno,0,0,0,0,1,0,1
cassette,0,0,0,0,1,0,1
otis,0,0,0,1,0,0,1
the marriage of figaro,1,0,0,0,0,0,1
cinderblock,0,0,0,1,0,0,1
plow,0,0,0,1,0,0,1
contender,0,0,0,0,1,0,1
falkirk,0,0,0,0,1,0,1
noctis,0,0,0,0,1,0,1
beheading,0,0,0,0,1,0,1
gopal,0,0,0,0,1,0,1
looper,0,0,0,1,0,0,1
longshanks,0,0,0,0,1,0,1
lancer,0,0,0,0,1,0,1
gat,0,0,0,1,0,0,1
mo,0,0,0,1,0,0,1
wearer,0,0,0,1,0,0,1
stirling,0,0,0,0,1,0,1
noble,0,0,0,0,1,0,1
/nandu,0,0,0,0,1,0,1
ages,0,0,0,1,0,0,1
scots,0,0,0,0,1,0,1
kar,0,0,0,1,0,0,1
nimh,0,0,0,1,0,0,1
bajji,0,0,0,0,1,0,1
suzie,0,0,0,1,0,0,1
malli,0,0,0,0,1,0,1
scottish,0,0,0,0,1,0,1
nandu,0,0,0,0,1,0,1
joes,0,0,0,1,0,0,1
baji,0,0,0,0,1,0,1
anjaneya prasad,0,0,0,0,1,0,1
murron,0,0,0,0,1,0,1
laundering,1,0,0,0,0,0,1
keerikadan,0,0,0,0,1,0,1
primae,0,0,0,0,1,0,1
barge,0,0,0,0,1,0,1
jenner,0,0,0,1,0,0,1
farmer fitzgibbons,0,0,0,1,0,0,1
kid blue,0,0,0,1,0,0,1
lochlan,0,0,0,0,1,0,1
rainmaker,0,0,0,1,0,0,1
showgirl,0,0,0,1,0,0,1
abe,0,0,0,1,0,0,1
the battle of falkirk,0,0,0,0,1,0,1
macclannough,0,0,0,0,1,0,1
simmons,0,0,0,1,0,0,1
muck,0,0,0,1,0,0,1
recourse,0,0,0,0,1,0,1
azhagan,0,0,0,0,1,0,1
allenby,0,0,0,0,1,0,1
paan singh's,0,0,0,0,1,0,1
kryptonite,0,0,0,1,0,0,1
juice,0,0,0,1,0,0,1
tayi,0,0,0,0,1,0,1
tafas,0,0,0,0,1,0,1
nefud,0,0,0,0,1,0,1
educational,1,0,0,0,0,0,1
pique,0,0,0,0,1,0,1
assessment,0,0,0,0,1,0,1
the arab bureau,0,0,0,0,1,0,1
aqaba,0,0,0,0,1,0,1
dobbs,0,0,0,0,1,0,1
brighton,0,0,0,0,1,0,1
madre,0,0,0,0,1,0,1
sierra,0,0,0,0,1,0,1
sherif,0,0,0,0,1,0,1
tampico,0,0,0,0,1,0,1
kal-el's,0,0,0,1,0,0,1
curtin,0,0,0,0,1,0,1
sierra madre,0,0,0,0,1,0,1
hinterland,0,0,0,0,1,0,1
paranoia,0,0,0,0,1,0,1
azaghu,0,0,0,0,1,0,1
hoverboard,0,0,0,1,0,0,1
seamus,0,0,0,1,0,0,1
identification,0,0,0,0,1,0,1
firebox,0,0,0,1,0,0,1
birch,0,0,0,0,1,0,1
khabarovsk,0,0,0,0,1,0,1
doc’s,0,0,0,1,0,0,1
united states cavalry,0,0,0,1,0,0,1
arseniev,0,0,0,0,1,0,1
equanimity,0,0,0,0,1,0,1
stove,0,0,0,1,0,0,1
provision,0,0,0,0,1,0,1
indios,0,0,0,0,1,0,1
prospector,0,0,0,0,1,0,1
uzala,0,0,0,0,1,0,1
dersu,0,0,0,0,1,0,1
siberian,0,0,0,0,1,0,1
solitary,1,0,0,0,0,0,1
nanai,0,0,0,0,1,0,1
clockwork,0,0,0,1,0,0,1
cody,0,0,0,0,1,0,1
surveying,0,0,0,0,1,0,1
ussuri,0,0,0,0,1,0,1
shkotovo,0,0,0,0,1,0,1
aftershock,0,0,0,1,0,0,1
daud,0,0,0,0,1,0,1
luthor,0,0,0,1,0,0,1
"the sinai desert,",0,0,0,0,1,0,1
browns,0,0,0,1,0,0,1
insurrectionist,0,0,0,1,0,0,1
doc's,0,0,0,1,0,0,1
howeitat,0,0,0,0,1,0,1
plot|datemagnetic,0,0,0,1,0,0,1
bombcannon,0,0,0,1,0,0,1
kal,0,0,0,1,0,0,1
kal-el,0,0,0,1,0,0,1
gasim,0,0,0,0,1,0,1
arabs,0,0,0,0,1,0,1
cops,0,0,0,0,1,0,1
push,0,0,0,0,1,0,1
oasis,0,0,0,0,1,0,1
daraa,0,0,0,0,1,0,1
lex,0,0,0,1,0,0,1
cutthroat,0,0,0,0,1,0,1
krypton,0,0,0,1,0,0,1
rosestink,0,0,0,1,0,0,1
lois,0,0,0,1,0,0,1
bedouins,0,0,0,0,1,0,1
lodge,0,0,0,0,1,0,1
eminence,0,0,0,1,0,0,1
dryden,0,0,0,0,1,0,1
qualm,0,0,0,0,1,0,1
the san andreas fault,0,0,0,1,0,0,1
usefulness,0,0,0,0,1,0,1
kanugu,0,0,0,0,1,0,1
jor,0,0,0,1,0,0,1
subramaniapuram,0,0,0,0,1,0,1
them &,0,0,0,0,1,0,1
madurai city,0,0,0,0,1,0,1
arabia,0,0,0,0,1,0,1
dopa,0,0,0,0,1,0,1
councilor,0,0,0,0,1,0,1
utility,0,0,0,0,1,0,1
bedouin,0,0,0,0,1,0,1
azaghar,0,0,0,0,1,0,1
azhagar,0,0,0,0,1,0,1
tulasi,0,0,0,0,1,0,1
barren,0,0,0,1,0,0,1
azhagu,0,0,0,0,1,0,1
brooks,1,0,0,0,0,0,1
bentley,0,0,0,0,1,0,1
polio,0,0,0,0,1,0,1
spur,0,0,0,1,0,0,1
the chambal valley,0,0,0,0,1,0,1
baaghi,0,0,0,0,1,0,1
unnam,0,0,0,0,1,0,1
valli,0,0,0,0,1,0,1
cool,0,0,0,1,0,0,1
weena,0,0,0,1,0,0,1
leeds,0,0,0,1,0,0,1
bonding,0,0,0,0,1,0,1
virumaandi,0,0,0,0,1,0,1
panchayata,0,0,0,0,1,0,1
nallama naicker,0,0,0,0,1,0,1
kannan,0,0,0,0,1,0,1
morlocks,0,0,0,1,0,0,1
kothala,0,0,0,0,1,0,1
napoleon,0,0,0,0,1,0,1
kathamuthu,0,0,0,0,1,0,1
annalakshmi,0,0,0,0,1,0,1
filby,0,0,0,1,0,0,1
obi,0,0,0,1,0,0,1
qui,0,0,0,1,0,0,1
rohini,0,0,0,0,1,0,1
the subterranean caverns,0,0,0,1,0,0,1
naicker,0,0,0,0,1,0,1
goldi,0,0,0,0,1,0,1
jinn,0,0,0,1,0,0,1
transaction,0,0,0,0,1,0,1
the united kingdom,0,0,0,1,0,0,1
kenobi,0,0,0,1,0,0,1
clout,0,0,0,0,1,0,1
vijayan,0,0,0,0,1,0,1
astrophysicist,0,0,0,1,0,0,1
parachutist,0,0,0,0,1,0,1
explores,0,0,0,1,0,0,1
infuriates,0,0,0,0,1,0,1
penance,0,0,0,0,1,0,1
kin,0,0,0,0,1,0,1
the psychiatric institute of manhattan,0,0,0,1,0,0,1
the anti corruption force,0,0,0,0,1,0,1
elois,0,0,0,1,0,0,1
psychiatric,0,0,0,1,0,0,1
nallama,0,0,0,0,1,0,1
central jail,0,0,0,0,1,0,1
cabot,0,0,0,1,0,0,1
cogent,0,0,0,1,0,0,1
acf,0,0,0,0,1,0,1
',0,0,0,1,0,0,1
thasildars,0,0,0,0,1,0,1
virtue,0,0,0,0,1,0,1
prot,0,0,0,1,0,0,1
redshirt,0,0,0,1,0,0,1
james filby,0,0,0,1,0,0,1
lyra,0,0,0,1,0,0,1
arasi,0,0,0,0,1,0,1
bidder,0,0,0,0,1,0,1
planetary,0,0,0,1,0,0,1
roadhouse,0,0,0,0,1,0,1
ueda,0,0,0,1,0,0,1
jp/sonoshee,0,0,0,1,0,0,1
assumption,0,0,0,0,1,0,1
sonoshee,0,0,0,1,0,0,1
sweetwater,0,0,0,0,1,0,1
trava&shinkai,0,0,0,1,0,0,1
honai,0,0,0,0,1,0,1
kalai,0,0,0,0,1,0,1
ashokan,0,0,0,0,1,0,1
hariharnagar,0,0,0,0,1,0,1
madhavan,0,0,0,0,1,0,1
malla,0,0,0,0,1,0,1
kenji koiso,0,0,0,1,0,0,1
racer,0,0,0,1,0,0,1
angina,0,0,0,1,0,0,1
siddique,0,0,0,0,1,0,1
roboworld,0,0,0,1,0,0,1
wabisuke,0,0,0,1,0,0,1
miki&todoroki,0,0,0,1,0,0,1
cheyenne,0,0,0,0,1,0,1
gunfighters,0,0,0,0,1,0,1
distributor,0,0,0,0,1,0,1
naidu,0,0,0,0,1,0,1
averson,0,0,0,1,0,0,1
stepson,0,0,0,0,1,0,1
sai,0,0,0,0,1,0,1
redshirts,0,0,0,1,0,0,1
happenstance,0,0,0,0,1,0,1
gon,0,0,0,1,0,0,1
new hope,0,0,0,1,0,0,1
loathing,0,0,0,0,1,0,1
vani,0,0,0,0,1,0,1
morton,0,0,0,0,1,0,1
basha,0,0,0,0,1,0,1
rajini,0,0,0,0,1,0,1
loknath,0,0,0,0,1,0,1
mitra,0,0,0,0,1,0,1
mcbain,0,0,0,0,1,0,1
artiste,0,0,0,0,1,0,1
flagstone,0,0,0,0,1,0,1
zeroing,0,0,0,1,0,0,1
mgr,0,0,0,0,1,0,1
glasha,0,0,0,0,1,0,1
fugue,0,0,0,0,1,0,1
the international military games,0,0,0,0,1,0,1
svt-40,0,0,0,0,1,0,1
buxton,1,0,0,0,0,0,1
perekhody,0,0,0,0,1,0,1
bog,0,0,0,0,1,0,1
steeplechase,0,0,0,0,1,0,1
sympathiser,0,0,0,0,1,0,1
editing,0,0,0,1,0,0,1
auntie,0,0,0,1,0,0,1
grenades,0,0,0,0,1,0,1
yustin,0,0,0,0,1,0,1
zhen,0,0,0,1,0,0,1
weeping,0,0,0,0,1,0,1
timothy,0,0,0,1,0,0,1
puddle,0,0,0,0,1,0,1
wen,0,0,0,1,0,0,1
brisby,0,0,0,1,0,0,1
the asian games,0,0,0,0,1,0,1
tomar,0,0,0,0,1,0,1
the district collector,0,0,0,0,1,0,1
veil,0,0,0,1,0,0,1
asian,0,0,0,0,1,0,1
chambal,0,0,0,0,1,0,1
regress,0,0,0,0,1,0,1
watching,0,0,0,0,1,0,1
morena,0,0,0,0,1,0,1
pneumonia,0,0,0,1,0,0,1
chambal valley,0,0,0,0,1,0,1
jeremy,0,0,0,1,0,0,1
bai,0,0,0,1,0,0,1
sensuality,0,0,0,1,0,0,1
chronologically,0,0,0,1,0,0,1
hamish,0,0,0,0,1,0,1
lulu,0,0,0,1,0,0,1
wai,0,0,0,1,0,0,1
the indian national games,0,0,0,0,1,0,1
sportsman,0,0,0,0,1,0,1
shaming,0,0,0,0,1,0,1
birdcage,0,0,0,1,0,0,1
chess,1,0,0,0,0,0,1
jie,0,0,0,1,0,0,1
bannockburn,0,0,0,0,1,0,1
nicodemus,0,0,0,1,0,0,1
paan singh,0,0,0,0,1,0,1
tears,0,0,0,1,0,0,1
longshank,0,0,0,0,1,0,1
renovation,0,0,0,1,0,0,1
general educational development,1,0,0,0,0,0,1
dusk,0,0,0,0,1,0,1
pax,0,0,0,1,0,0,1
partisan,0,0,0,0,1,0,1
byelorussian,0,0,0,0,1,0,1
thasildar,0,0,0,0,1,0,1
fare,0,0,0,1,0,0,1
pane,0,0,0,1,0,0,1
militiaman,0,0,0,0,1,0,1
cowl,0,0,0,1,0,0,1
talking,0,0,0,1,0,0,1
the time machine,0,0,0,1,0,0,1
copperhead,0,0,0,1,0,0,1
eloi,0,0,0,1,0,0,1
aeroplane,0,0,0,0,1,0,1
bronson,0,0,0,1,0,0,1
byelorussia,0,0,0,0,1,0,1
glafira,0,0,0,0,1,0,1
blare,0,0,0,1,0,0,1
threatening,0,0,0,0,1,0,1
flyora,0,0,0,0,1,0,1
calling,0,0,0,1,0,0,1
no.1,0,0,0,0,1,0,1
chainmail,0,0,0,1,0,0,1
roubej,0,0,0,0,1,0,1
recruit,0,0,0,0,1,0,1
ling,0,0,0,1,0,0,1
vijayakanth,0,0,0,0,1,0,1
nazi einsatzkommando,0,0,0,0,1,0,1
justin,0,0,0,1,0,0,1
wang,0,0,0,1,0,0,1
yuddy,0,0,0,1,0,0,1
owl,0,0,0,1,0,0,1
games,0,0,0,0,1,0,1
bhanwar,0,0,0,0,1,0,1
oven,0,0,0,0,1,0,1
inferno,0,0,0,0,1,0,1
traces,0,0,0,1,0,0,1
hiatus,0,0,0,0,1,0,1
hatlen,1,0,0,0,0,0,1
schoolboy,0,0,0,0,1,0,1
thorn valley,0,0,0,1,0,0,1
clampdown,1,0,0,0,0,0,1
qipao,0,0,0,1,0,0,1
reader,0,0,0,1,0,0,1
kosach,0,0,0,0,1,0,1
hillyer,0,0,0,1,0,0,1
einsatzkommando,0,0,0,0,1,0,1
yugi,0,0,0,0,1,0,1
verification,0,0,0,0,1,0,1
the organic nutrients,0,0,0,1,0,0,1
noa,0,0,0,1,0,0,1
shin,0,0,0,1,0,0,1
graveley,0,0,0,1,0,0,1
kenshiro,0,0,0,1,0,0,1
shinken,0,0,0,1,0,0,1
the city of wailing demons,0,0,0,1,0,0,1
morph,0,0,0,1,0,0,1
erupts,0,0,0,1,0,0,1
the nanto seiken,0,0,0,1,0,0,1
the interstellar academy,0,0,0,1,0,0,1
load,0,0,0,1,0,0,1
maguire,0,0,0,1,0,0,1
countdown,0,0,0,1,0,0,1
doomed,0,0,0,1,0,0,1
saved,0,0,0,1,0,0,1
demons,0,0,0,1,0,0,1
oyama,0,0,0,1,0,0,1
southern cross,0,0,0,1,0,0,1
nanto,0,0,0,1,0,0,1
jeannie,0,0,0,1,0,0,1
hokuto,0,0,0,1,0,0,1
the british met office,0,0,0,1,0,0,1
marching,0,0,0,1,0,0,1
cassandra,0,0,0,1,0,0,1
temperature,0,0,0,1,0,0,1
express,0,0,0,1,0,0,1
dojo,0,0,0,1,0,0,1
jeanie,0,0,0,1,0,0,1
ryuken,0,0,0,1,0,0,1
jagi,0,0,0,1,0,0,1
nanto seiken,0,0,0,1,0,0,1
airi,0,0,0,1,0,0,1
first mate,0,0,0,1,0,0,1
hyun-seo back,0,0,0,1,0,0,1
jo,0,0,0,1,0,0,1
disastrology,0,0,0,1,0,0,1
actuality,0,0,0,1,0,0,1
doppler,0,0,0,1,0,0,1
seo,0,0,0,1,0,0,1
se,0,0,0,1,0,0,1
scroop,0,0,0,1,0,0,1
pastime,0,0,0,1,0,0,1
il,0,0,0,1,0,0,1
b.e.n,0,0,0,1,0,0,1
precipice,0,0,0,1,0,0,1
delbert,0,0,0,1,0,0,1
mutineer,0,0,0,1,0,0,1
interstellar,0,0,0,1,0,0,1
the han river,0,0,0,1,0,0,1
storybook,0,0,0,1,0,0,1
amelia,0,0,0,1,0,0,1
lifeline,0,0,0,1,0,0,1
hee,0,0,0,1,0,0,1
b.e.n.,0,0,0,1,0,0,1
wonhyo,0,0,0,1,0,0,1
spaceport,0,0,0,1,0,0,1
nam,0,0,0,1,0,0,1
noticing,0,0,0,1,0,0,1
rls,0,0,0,1,0,0,1
joo,0,0,0,1,0,0,1
se-joo,0,0,0,1,0,0,1
editorial,0,0,0,1,0,0,1
wailing,0,0,0,1,0,0,1
siberia,0,0,0,1,0,0,1
harlock,0,0,0,1,0,0,1
halsey,0,0,0,1,0,0,1
triter,0,0,0,1,0,0,1
miskatonic university,0,0,0,1,0,0,1
miskatonic,0,0,0,1,0,0,1
the flame stream prominence,0,0,0,1,0,0,1
dismemberment,0,0,0,1,0,0,1
traversing,0,0,0,1,0,0,1
the owen stanley mountains,0,0,0,1,0,0,1
tokargans,0,0,0,1,0,0,1
morgue,0,0,0,1,0,0,1
illumidus,0,0,0,1,0,0,1
tochiro,0,0,0,1,0,0,1
messerschmitt,0,0,0,1,0,0,1
reagent,0,0,0,1,0,0,1
phantom f. harlock,0,0,0,1,0,0,1
emeraldas,0,0,0,1,0,0,1
guardianship,0,0,0,1,0,0,1
iron cross,0,0,0,1,0,0,1
zurich university institute of medicine,0,0,0,1,0,0,1
deathshadow,0,0,0,1,0,0,1
revi,0,0,0,1,0,0,1
goethe,0,0,0,1,0,0,1
the owen stanley witch,0,0,0,1,0,0,1
queer,1,0,0,0,0,0,1
c-12d,0,0,0,1,0,0,1
iscandar,0,0,0,1,0,0,1
gamilons,0,0,0,1,0,0,1
shawshank,1,0,0,0,0,0,1
|urlnew,0,0,0,1,0,0,1
encouragement,0,0,0,1,0,0,1
claire,0,0,0,1,0,0,1
telephonist,0,0,0,1,0,0,1
seiken,0,0,0,1,0,0,1
stenning,0,0,0,1,0,0,1
raoh's dungeon,0,0,0,1,0,0,1
met,0,0,0,1,0,0,1
yuria,0,0,0,1,0,0,1
raoh,0,0,0,1,0,0,1
teepee,0,0,0,1,0,0,1
hayworth,1,0,0,0,0,0,1
outcome,0,0,0,1,0,0,1
antares,0,0,0,1,0,0,1
leitmotifs.<ref,0,0,0,1,0,0,1
the daily express,0,0,0,1,0,0,1
intuition,0,0,0,1,0,0,1
satchel,0,0,0,1,0,0,1
saw,0,0,0,1,0,0,1
assertion,0,0,0,1,0,0,1
by,0,0,0,1,0,0,1
flyby,0,0,0,1,0,0,1
|date2,0,0,0,1,0,0,1
dosage,0,0,0,1,0,0,1
riding,0,0,0,1,0,0,1
melancholia,0,0,0,1,0,0,1
nap,0,0,0,1,0,0,1
rita,1,0,0,0,0,0,1
cain,0,0,0,1,0,0,1
giantmelancholia,0,0,0,1,0,0,1
seos,0,0,0,1,0,0,1
hyun-seo,0,0,0,1,0,0,1
bong,0,0,0,1,0,0,1
psycho,0,0,0,1,0,0,1
sherlock,0,0,0,1,0,0,1
scrivello,0,0,0,1,0,0,1
nourishment,0,0,0,1,0,0,1
orin scrivello d.d.s,0,0,0,1,0,0,1
|datedvd,0,0,0,1,0,0,1
put,0,0,0,1,0,0,1
peterson,0,0,0,1,0,0,1
country.<ref,0,0,0,1,0,0,1
the los angeles river,0,0,0,1,0,0,1
mushnik,0,0,0,1,0,0,1
zihuatanejo,1,0,0,0,0,0,1
outer,0,0,0,1,0,0,1
gramps,0,0,0,1,0,0,1
mushnik's flower shop,0,0,0,1,0,0,1
craze,0,0,0,1,0,0,1
seymour,0,0,0,1,0,0,1
ditzy,0,0,0,1,0,0,1
oxide,0,0,0,1,0,0,1
bogs,1,0,0,0,0,0,1
u.s. air force,0,0,0,1,0,0,1
register,0,0,0,1,0,0,1
namehttp://www.dvdtalk.com/dvdsavant/s92shop.html,0,0,0,1,0,0,1
consumer,0,0,0,1,0,0,1
ellinson,0,0,0,1,0,0,1
orin,0,0,0,1,0,0,1
savant,0,0,0,1,0,0,1
hancock,1,0,0,0,0,0,1
iis,0,0,0,1,0,0,1
d.d.s,0,0,0,1,0,0,1
the 'happy carrot' health-food,0,0,0,1,0,0,1
asphyxiation,0,0,0,1,0,0,1
speculation,0,0,0,1,0,0,1
senselessness,0,0,0,1,0,0,1
ava,0,0,0,1,0,0,1
o'brien,0,0,0,1,0,0,1
fluttering,0,0,0,1,0,0,1
crotty,0,0,0,1,0,0,1
medford,0,0,0,1,0,0,1
calamity,0,0,0,1,0,0,1
khanjian,0,0,0,1,0,0,1
duncan,0,0,0,1,0,0,1
submachine,0,0,0,1,0,0,1
arsinée,0,0,0,1,0,0,1
guantanamera,0,0,0,1,0,0,1
saucer,0,0,0,1,0,0,1
festivity,0,0,0,1,0,0,1
polley,0,0,0,1,0,0,1
agriculture,0,0,0,1,0,0,1
burroughs,0,0,0,1,0,0,1
the department of agriculture,0,0,0,1,0,0,1
empty,0,0,0,1,0,0,1
streetcar,0,0,0,1,0,0,1
plaster,0,0,0,1,0,0,1
krelborn,0,0,0,1,0,0,1
audrey,0,0,0,1,0,0,1
audrey ii,0,0,0,1,0,0,1
ladder,0,0,0,1,0,0,1
appointment,0,0,0,1,0,0,1
assassinates,0,0,0,1,0,0,1
beck,0,0,0,1,0,0,1
formaldehyde,0,0,0,1,0,0,1
susra,0,0,0,1,0,0,1
kasauli,0,0,0,1,0,0,1
rohit,0,0,0,1,0,0,1
agility,0,0,0,1,0,0,1
stéphanie,0,0,0,1,0,0,1
typesetting,0,0,0,1,0,0,1
om,0,0,0,1,0,0,1
psychokinesis,0,0,0,1,0,0,1
mehra,0,0,0,1,0,0,1
neuroscience,0,0,0,1,0,0,1
michel,0,0,0,1,0,0,1
discourse,0,0,0,1,0,0,1
zoé,0,0,0,1,0,0,1
weizenbaum,0,0,0,1,0,0,1
roboticists,0,0,0,1,0,0,1
biology,0,0,0,1,0,0,1
pioneers,0,0,0,1,0,0,1
kurzweil,0,0,0,1,0,0,1
shackle,0,0,0,1,0,0,1
gondry,0,0,0,1,0,0,1
stéphane and stéphanie,0,0,0,1,0,0,1
miroux,0,0,0,1,0,0,1
stéphane,0,0,0,1,0,0,1
merge,0,0,0,1,0,0,1
ishiguro,0,0,0,1,0,0,1
realises,0,0,0,1,0,0,1
welch,1,0,0,0,0,0,1
dus,0,0,0,1,0,0,1
randomness,0,0,0,1,0,0,1
vacancy,0,0,0,1,0,0,1
"the ""aires project",0,0,0,1,0,0,1
exclaims,0,0,0,1,0,0,1
brainwashing,0,0,0,1,0,0,1
windt,0,0,0,1,0,0,1
mandible,0,0,0,1,0,0,1
cryopreservation,0,0,0,1,0,0,1
erno,0,0,0,1,0,0,1
the aires project,0,0,0,1,0,0,1
blackburn,0,0,0,1,0,0,1
entomologist,0,0,0,1,0,0,1
incompatibility,0,0,0,1,0,0,1
new mexico state police,0,0,0,1,0,0,1
traveling,0,0,0,1,0,0,1
barrel,0,0,0,1,0,0,1
loading,0,0,0,1,0,0,1
vasectomy,0,0,0,1,0,0,1
lottery,0,0,0,1,0,0,1
preteen,0,0,0,1,0,0,1
alamogordo,0,0,0,1,0,0,1
centimeter,0,0,0,1,0,0,1
thomson,0,0,0,1,0,0,1
detamble,0,0,0,1,0,0,1
alba,0,0,0,1,0,0,1
clare,0,0,0,1,0,0,1
calendar,0,0,0,1,0,0,1
synchronized,0,0,0,1,0,0,1
nisha,0,0,0,1,0,0,1
disasterology,0,0,0,1,0,0,1
steering,0,0,0,1,0,0,1
solar federation,0,0,0,1,0,0,1
altitude,0,0,0,1,0,0,1
weekend,0,0,0,1,0,0,1
dissension,0,0,0,1,0,0,1
kusaka,0,0,0,1,0,0,1
masaki,0,0,0,1,0,0,1
bound,0,0,0,1,0,0,1
takeshi,0,0,0,1,0,0,1
sakisaka,0,0,0,1,0,0,1
allusion,0,0,0,1,0,0,1
smart,0,0,0,1,0,0,1
osada,0,0,0,1,0,0,1
the time of eve,0,0,0,1,0,0,1
koji,0,0,0,1,0,0,1
horse orphnoch,0,0,0,1,0,0,1
isaac,0,0,0,1,0,0,1
"mike, crow",0,0,0,1,0,0,1
murakami,0,0,0,1,0,0,1
the earth forces,0,0,0,1,0,0,1
the orphnochs yuji kiba,0,0,0,1,0,0,1
mari,0,0,0,1,0,0,1
kamen rider psyga,0,0,0,1,0,0,1
riffing,0,0,0,1,0,0,1
kiba,0,0,0,1,0,0,1
aronnax,0,0,0,1,0,0,1
taking,0,0,0,1,0,0,1
nelson,0,0,0,1,0,0,1
metalunan,0,0,0,1,0,0,1
filmstrip,0,0,0,1,0,0,1
shipping,0,0,0,1,0,0,1
manos,0,0,0,1,0,0,1
penthe,0,0,0,1,0,0,1
nagi,0,0,0,1,0,0,1
riotroopers,0,0,0,1,0,0,1
overarching,0,0,0,1,0,0,1
kikuchi,0,0,0,1,0,0,1
valium,0,0,0,1,0,0,1
mizuhara,0,0,0,1,0,0,1
barf,0,0,0,1,0,0,1
yuka,0,0,0,1,0,0,1
kaido,0,0,0,1,0,0,1
inui,0,0,0,1,0,0,1
keitaro,0,0,0,1,0,0,1
skroob,0,0,0,1,0,0,1
orga,0,0,0,1,0,0,1
orphnochs,0,0,0,1,0,0,1
belts,0,0,0,1,0,0,1
kyoji,0,0,0,1,0,0,1
orphenoch,0,0,0,1,0,0,1
kamen rider orga,0,0,0,1,0,0,1
the faiz edge,0,0,0,1,0,0,1
chie,0,0,0,1,0,0,1
akiko,0,0,0,1,0,0,1
three,0,0,0,1,0,0,1
barista,0,0,0,1,0,0,1
rina,0,0,0,1,0,0,1
combatant,0,0,0,1,0,0,1
bubbly,0,0,0,1,0,0,1
blaster form,0,0,0,1,0,0,1
masakazu,0,0,0,1,0,0,1
rikuo,0,0,0,1,0,0,1
auto vajin,0,0,0,1,0,0,1
asimov,0,0,0,1,0,0,1
salon,0,0,0,1,0,0,1
this island earth,0,0,0,1,0,0,1
interocitor,0,0,0,1,0,0,1
hugh,0,0,0,1,0,0,1
castaway,0,0,0,1,0,0,1
brig,0,0,0,1,0,0,1
apprehension,0,0,0,1,0,0,1
t'ai,0,0,0,1,0,0,1
jackman,0,0,0,1,0,0,1
firstkolakowski,0,0,0,1,0,0,1
franciscan,0,0,0,1,0,0,1
name51–52,0,0,0,1,0,0,1
tumor,0,0,0,1,0,0,1
intricacy,0,0,0,1,0,0,1
cleric,0,0,0,1,0,0,1
mayans,0,0,0,1,0,0,1
nutrient,0,0,0,1,0,0,1
mortality,0,0,0,1,0,0,1
weisz,0,0,0,1,0,0,1
new spain,0,0,0,1,0,0,1
tomás,0,0,0,1,0,0,1
inquisitor,0,0,0,1,0,0,1
the new world,0,0,0,1,0,0,1
hugh jackman,0,0,0,1,0,0,1
biblical,0,0,0,1,0,0,1
nebula,0,0,0,1,0,0,1
titlewashington,0,0,0,1,0,0,1
sap,0,0,0,1,0,0,1
aronofsky,0,0,0,1,0,0,1
conquistadora,0,0,0,1,0,0,1
the biblical tree of life,0,0,0,1,0,0,1
izzi,0,0,0,1,0,0,1
reenactment,0,0,0,1,0,0,1
vulcania,0,0,0,1,0,0,1
fountain{{'}}s,0,0,0,1,0,0,1
submerging,0,0,0,1,0,0,1
metaluna,0,0,0,1,0,0,1
servo,0,0,0,1,0,0,1
zap,0,0,0,1,0,0,1
biosphere,0,0,0,1,0,0,1
avenue,0,0,0,1,0,0,1
xibalba,0,0,0,1,0,0,1
crowd|thumb|150px|one,0,0,0,1,0,0,1
narratives.<ref,0,0,0,1,0,0,1
harpooneer,0,0,0,1,0,0,1
correlation,0,0,0,1,0,0,1
darren,0,0,0,1,0,0,1
namehttp://www.washingtonpost.com/wp-dyn/content/article/2006/11/23/ar2006112300534.html,0,0,0,1,0,0,1
the spanish inquisition,0,0,0,1,0,0,1
squid,0,0,0,1,0,0,1
neuroscientist,0,0,0,1,0,0,1
redding,1,0,0,0,0,0,1
myth,0,0,0,1,0,0,1
rura,0,0,0,1,0,0,1
meditates,0,0,0,1,0,0,1
urgency,0,0,0,1,0,0,1
halting,0,0,0,1,0,0,1
datenovember&nbsp;27,0,0,0,1,0,0,1
the tree of life,0,0,0,1,0,0,1
munition,0,0,0,1,0,0,1
convergence,0,0,0,1,0,0,1
conseil,0,0,0,1,0,0,1
winnebago,0,0,0,1,0,0,1
spaceballs,0,0,0,1,0,0,1
mawg,0,0,0,1,0,0,1
opus,0,0,0,1,0,0,1
delambre,0,0,0,1,0,0,1
transporter,0,0,0,1,0,0,1
owens,0,0,0,1,0,0,1
integrator,0,0,0,1,0,0,1
francois,0,0,0,1,0,0,1
mixing,0,0,0,1,0,0,1
tulse,0,0,0,1,0,0,1
suitcases,0,0,0,1,0,0,1
andre,0,0,0,1,0,0,1
epicentre,0,0,0,1,0,0,1
quay,0,0,0,1,0,0,1
farra,0,0,0,1,0,0,1
the bird facilities investments,0,0,0,1,0,0,1
oddity,0,0,0,1,0,0,1
twin cities',0,0,0,1,0,0,1
black thunder,0,0,0,1,0,0,1
deadpan,0,0,0,1,0,0,1
world robot boxing league,0,0,0,1,0,0,1
fall-,0,0,0,1,0,0,1
hitchcock,0,0,0,1,0,0,1
ailment,0,0,0,1,0,0,1
promoter,0,0,0,1,0,0,1
lemkova,0,0,0,1,0,0,1
cities,0,0,0,1,0,0,1
twin cities,0,0,0,1,0,0,1
violent,0,0,0,1,0,0,1
finn,0,0,0,1,0,0,1
greenaway,0,0,0,1,0,0,1
colpitts,0,0,0,1,0,0,1
novelty,0,0,0,1,0,0,1
propine,0,0,0,1,0,0,1
bf,0,0,0,1,0,0,1
the space battleship yamato,0,0,0,1,0,0,1
starsha,0,0,0,1,0,0,1
application,0,0,0,1,0,0,1
birds,0,0,0,1,0,0,1
facilities,0,0,0,1,0,0,1
prominence,0,0,0,1,0,0,1
tulse luper,0,0,0,1,0,0,1
drowning,0,0,0,1,0,0,1
the illumidus empire,0,0,0,1,0,0,1
numbers,0,0,0,1,0,0,1
disables,0,0,0,1,0,0,1
biography,0,0,0,1,0,0,1
noughts,0,0,0,1,0,0,1
fallax,0,0,0,1,0,0,1
illumidas,0,0,0,1,0,0,1
the brothers quay,0,0,0,1,0,0,1
dogfight,0,0,0,1,0,0,1
ipson,0,0,0,1,0,0,1
warzone,0,0,0,1,0,0,1
daedalus,0,0,0,1,0,0,1
pulat,0,0,0,1,0,0,1
owen,0,0,0,1,0,0,1
arcadia,0,0,0,1,0,0,1
fuselage,0,0,0,1,0,0,1
toshiro,0,0,0,1,0,0,1
correspond,0,0,0,1,0,0,1
luper,0,0,0,1,0,0,1
boxer,0,0,0,1,0,0,1
merchandising,0,0,0,1,0,0,1
kaixa,0,0,0,1,0,0,1
kamen,0,0,0,1,0,0,1
naoya,0,0,0,1,0,0,1
tallet,0,0,0,1,0,0,1
druidia,0,0,0,1,0,0,1
sonoda,0,0,0,1,0,0,1
dark helmet,0,0,0,1,0,0,1
spaceball one,0,0,0,1,0,0,1
riotrooper,0,0,0,1,0,0,1
sandurz,0,0,0,1,0,0,1
vespa,0,0,0,1,0,0,1
roland,0,0,0,1,0,0,1
droid,0,0,0,1,0,0,1
schwartz,0,0,0,1,0,0,1
kamen rider,0,0,0,1,0,0,1
spaceball,0,0,0,1,0,0,1
masato,0,0,0,1,0,0,1
hyperspace,0,0,0,1,0,0,1
king roland,0,0,0,1,0,0,1
smart brain super arena,0,0,0,1,0,0,1
hutt,0,0,0,1,0,0,1
behemoth,0,0,0,1,0,0,1
faiz,0,0,0,1,0,0,1
orphnoch,0,0,0,1,0,0,1
yogurt,0,0,0,1,0,0,1
mega,0,0,0,1,0,0,1
the elasmotherium orphnoch,0,0,0,1,0,0,1
vajin,0,0,0,1,0,0,1
kenton,0,0,0,1,0,0,1
nomura,0,0,0,1,0,0,1
secondhand,0,0,0,1,0,0,1
midas,0,0,0,1,0,0,1
"the ""violent unknown event",0,0,0,1,0,0,1
mashido,0,0,0,1,0,0,1
generation-2,0,0,0,1,0,0,1
punch,0,0,0,1,0,0,1
receptor,0,0,0,1,0,0,1
fallari,0,0,0,1,0,0,1
exhibition,0,0,0,1,0,0,1
cissie,0,0,0,1,0,0,1
propine fallax,0,0,0,1,0,0,1
the vue commission,0,0,0,1,0,0,1
noisy boy's,0,0,0,1,0,0,1
investments,0,0,0,1,0,0,1
zeus,0,0,0,1,0,0,1
vue,0,0,0,1,0,0,1
yuji,0,0,0,1,0,0,1
upstart,0,0,0,1,0,0,1
elasmotherium,0,0,0,1,0,0,1
psyga,0,0,0,1,0,0,1
the faiz belt,0,0,0,1,0,0,1
wrb,0,0,0,1,0,0,1
noisy boy,0,0,0,1,0,0,1
noisy,0,0,0,1,0,0,1
bot,0,0,0,1,0,0,1
naoya kaido,0,0,0,1,0,0,1
takumi,0,0,0,1,0,0,1
lost,0,0,0,1,0,0,1
goff,0,0,0,0,1,0,1
san diego,0,0,0,1,0,0,1
helius,0,0,0,1,0,0,1
mla,0,0,0,0,1,0,1
captain gantu's,0,0,0,1,0,0,1
councilwoman,0,0,0,1,0,0,1
aggressiveness,0,0,0,1,0,0,1
cherubic,0,0,0,1,0,0,1
stotzer,0,0,0,1,0,0,1
xylophone,0,0,0,1,0,0,1
assortment,0,0,0,1,0,0,1
je,0,0,0,1,0,0,1
"galaxie,{{cite",0,0,0,1,0,0,1
misraki,0,0,0,1,0,0,1
postulate|e,0,0,0,1,0,0,1
"mustang,{{cite",0,0,0,1,0,0,1
natacha,0,0,0,1,0,0,1
gantu,0,0,0,1,0,0,1
the planet earth,0,0,0,1,0,0,1
blu,0,0,0,1,0,0,1
enticement,0,0,0,1,0,0,1
lemmy caution,0,0,0,1,0,0,1
alphaville,0,0,0,1,0,0,1
"darke_1"">{{harv|darke|2005|palphaville",0,0,0,1,0,0,1
aime,0,0,0,1,0,0,1
captain gantu,0,0,0,1,0,0,1
outlands,0,0,0,1,0,0,1
lemmy,0,0,0,1,0,0,1
hawaii,0,0,0,1,0,0,1
alpha 60,0,0,0,1,0,0,1
hawaiian,0,0,0,1,0,0,1
book|titlegilberto|last358|publisher2000|isbn&nbsp;mc²,0,0,0,1,0,0,1
arne,0,0,0,1,0,0,1
nametomás,0,0,0,1,0,0,1
sara loo,0,0,0,1,0,0,1
lifeguard,0,0,0,1,0,0,1
corey,0,0,0,1,0,0,1
civilisation,0,0,0,1,0,0,1
corporate,0,0,0,1,0,0,1
aquarius,0,0,0,1,0,0,1
the galman empire,0,0,0,1,0,0,1
forbidden,0,0,0,1,0,0,1
galman,0,0,0,1,0,0,1
the forbidden chromosome *,0,0,0,1,0,0,1
kodai,0,0,0,1,0,0,1
famous,0,0,0,1,0,0,1
chromosome,0,0,0,1,0,0,1
namehttp://www.stingraysam.com/info.shtml|title2008-11-17|work2008-11-17,0,0,0,1,0,0,1
hydrogen,0,0,0,1,0,0,1
loo,0,0,0,1,0,0,1
vader,0,0,0,1,0,0,1
dreary,0,0,0,1,0,0,1
corporate mascot rehabilitation program,0,0,0,1,0,0,1
planet.<ref,0,0,0,1,0,0,1
stingray,0,0,0,1,0,0,1
quasar,0,0,0,1,0,0,1
notation,0,0,0,1,0,0,1
rehabilitation,0,0,0,1,0,0,1
shackles,0,0,0,1,0,0,1
darth,0,0,0,1,0,0,1
kaua{{okina}}i,0,0,0,1,0,0,1
jookiba,0,0,0,1,0,0,1
nani's,0,0,0,1,0,0,1
the galactic order,0,0,0,1,0,0,1
ruhmkorff,0,0,0,1,0,0,1
gertrude,0,0,0,1,0,0,1
pelekai,0,0,0,1,0,0,1
descendent,0,0,0,1,0,0,1
saknussem,0,0,0,1,0,0,1
potassium,0,0,0,1,0,0,1
atlantis,0,0,0,1,0,0,1
icelandic,0,0,0,1,0,0,1
correspondence,0,0,0,1,0,0,1
bjelke,0,0,0,1,0,0,1
göteborg,0,0,0,1,0,0,1
cassie,0,0,0,1,0,0,1
crisp,0,0,0,1,0,0,1
spencer,0,0,0,1,0,0,1
crumble,0,0,0,1,0,0,1
mary&nbsp;x,0,0,0,1,0,0,1
snakelike,0,0,0,1,0,0,1
queue,0,0,0,1,0,0,1
leak,0,0,0,1,0,0,1
causal,0,0,0,1,0,0,1
writhes,0,0,0,1,0,0,1
beautiful,0,0,0,1,0,0,1
expiration,0,0,0,1,0,0,1
causal adjust,0,0,0,1,0,0,1
imagineer,0,0,0,1,0,0,1
the beautiful girl across the hall,0,0,0,1,0,0,1
anchors,0,0,0,1,0,0,1
swaddling,0,0,0,1,0,0,1
petes,0,0,0,1,0,0,1
mural,0,0,0,1,0,0,1
adjust,0,0,0,1,0,0,1
mcewan,0,0,0,1,0,0,1
tooth,0,0,0,1,0,0,1
duckling,0,0,0,1,0,0,1
reverberation,0,0,0,1,0,0,1
cyanide,0,0,0,1,0,0,1
pleakley,0,0,0,1,0,0,1
stitch,0,0,0,1,0,0,1
nani,0,0,0,1,0,0,1
paisley,0,0,0,1,0,0,1
geologist,0,0,0,1,0,0,1
galactic,0,0,0,1,0,0,1
stem,0,0,0,1,0,0,1
whirlpool,0,0,0,1,0,0,1
lilo,0,0,0,1,0,0,1
mushroom,0,0,0,1,0,0,1
roswell,0,0,0,1,0,0,1
hijack,0,0,0,1,0,0,1
filling,0,0,0,1,0,0,1
jumba,0,0,0,1,0,0,1
lizard,0,0,0,1,0,0,1
alec,0,0,0,1,0,0,1
icelander,0,0,0,1,0,0,1
the university of edinburgh,0,0,0,1,0,0,1
byron,1,0,0,0,0,0,1
proportion,0,0,0,1,0,0,1
spermatozoon,0,0,0,1,0,0,1
cityscape,0,0,0,1,0,0,1
overload,0,0,0,1,0,0,1
goatee,0,0,0,1,0,0,1
eraser,0,0,0,1,0,0,1
lindenbrook,0,0,0,1,0,0,1
okita,0,0,0,1,0,0,1
galmania,0,0,0,1,0,0,1
fugitives,0,0,0,1,0,0,1
psyco,0,0,0,1,0,0,1
char,0,0,0,1,0,0,1
informs,0,0,0,0,1,0,1
humankind,0,0,0,1,0,0,1
shelob,0,0,0,0,1,0,1
dunharrow,0,0,0,0,1,0,1
andúril,0,0,0,0,1,0,1
undying,0,0,0,0,1,0,1
overwhelm,0,0,0,0,1,0,1
the black gate of mordor,0,0,0,0,1,0,1
the earth federation,0,0,0,1,0,0,1
the heir of isildur,0,0,0,0,1,0,1
inuit,0,0,0,1,0,0,1
expedient,0,0,0,1,0,0,1
followup,0,0,0,1,0,0,1
palantír,0,0,0,0,1,0,1
british intelligence,0,0,0,1,0,0,1
minas,0,0,0,0,1,0,1
melt,0,0,0,0,1,0,1
"elrond, celeborn",0,0,0,0,1,0,1
texture,0,0,0,1,0,0,1
gamling,0,0,0,0,1,0,1
zellaby,0,0,0,1,0,0,1
denethor,0,0,0,0,1,0,1
rowdyism,0,0,0,0,1,0,1
rowdy,0,0,0,0,1,0,1
satya,0,0,0,0,1,0,1
equivalent,0,0,0,1,0,0,1
paths,0,0,0,0,1,0,1
londo,0,0,0,1,0,0,1
witness protection program,0,0,0,0,1,0,1
sune,0,0,0,1,0,0,1
fracas,0,0,0,0,1,0,1
nu,0,0,0,1,0,0,1
londo bell,0,0,0,1,0,0,1
uc,0,0,0,1,0,0,1
zeon,0,0,0,1,0,0,1
hayfield,1,0,0,0,0,0,1
lhasa,0,0,0,1,0,0,1
remanan,0,0,0,0,1,0,1
the londo bell's,0,0,0,1,0,0,1
reentry,0,0,0,1,0,0,1
rx-93,0,0,0,1,0,0,1
gundam,0,0,0,1,0,0,1
neo zeon,0,0,0,1,0,0,1
beacon,0,0,0,0,1,0,1
haradrim,0,0,0,0,1,0,1
4th luna,0,0,0,1,0,0,1
the steward of gondor,0,0,0,0,1,0,1
the londo bell,0,0,0,1,0,0,1
gondorians,0,0,0,0,1,0,1
deduces,0,0,0,0,1,0,1
eagles,0,0,0,0,1,0,1
tirith,0,0,0,0,1,0,1
aznable,0,0,0,1,0,0,1
neo-zeon,0,0,0,1,0,0,1
amuro,0,0,0,1,0,0,1
axis,0,0,0,1,0,0,1
the undying lands,0,0,0,0,1,0,1
midwich,0,0,0,1,0,0,1
glow,0,0,0,1,0,0,1
the bolar federation,0,0,0,1,0,0,1
residents,0,0,0,1,0,0,1
scottie,0,0,0,1,0,0,1
starfleet command,0,0,0,1,0,0,1
anchorman,0,0,0,1,0,0,1
rumors,0,0,0,1,0,0,1
uhura and pavel chekov,0,0,0,1,0,0,1
"gracie""—in",0,0,0,1,0,0,1
leon,0,0,0,1,0,0,1
the pied piper of hamelin,0,0,0,1,0,0,1
dilithium,0,0,0,1,0,0,1
pavel,0,0,0,1,0,0,1
the cetacean institute,0,0,0,1,0,0,1
sausalito,0,0,0,1,0,0,1
"whales—""george",0,0,0,1,0,0,1
humpback,0,0,0,1,0,0,1
cetacean,0,0,0,1,0,0,1
detmer,0,0,0,1,0,0,1
tranquil,0,0,0,1,0,0,1
apex,0,0,0,1,0,0,1
aluminum,0,0,0,1,0,0,1
monica,0,0,0,1,0,0,1
bolar,0,0,0,1,0,0,1
denguil,0,0,0,1,0,0,1
chekov,0,0,0,1,0,0,1
the vulcan spock,0,0,0,1,0,0,1
desslar,0,0,0,1,0,0,1
planet bolar,0,0,0,1,0,0,1
protrusion,0,0,0,1,0,0,1
maneuver,0,0,0,1,0,0,1
keokuk,0,0,0,1,0,0,1
united states marshal,0,0,0,0,1,0,1
abhart,0,0,0,1,0,0,1
errant,0,0,0,1,0,0,1
soviet union,0,0,0,1,0,0,1
announcer,0,0,0,1,0,0,1
rsfsr,0,0,0,1,0,0,1
yosemite national park,0,0,0,1,0,0,1
normality,0,0,0,1,0,0,1
hamlin,0,0,0,1,0,0,1
cracker,0,0,0,1,0,0,1
exclusion,0,0,0,1,0,0,1
the emergency broadcast system,0,0,0,1,0,0,1
irkutsk,0,0,0,1,0,0,1
piper,0,0,0,1,0,0,1
taboo,0,0,0,1,0,0,1
pied,0,0,0,1,0,0,1
saavik,0,0,0,1,0,0,1
answering,0,0,0,1,0,0,1
cloaking,0,0,0,1,0,0,1
san francisco bay,0,0,0,1,0,0,1
shroud,0,0,0,1,0,0,1
hamelin,0,0,0,1,0,0,1
bay area,0,0,0,1,0,0,1
whaler,0,0,0,1,0,0,1
yosemite,0,0,0,1,0,0,1
ames,0,0,0,1,0,0,1
san francisco's,0,0,0,1,0,0,1
gracie,0,0,0,1,0,0,1
adjusts,0,0,0,1,0,0,1
|urlfilm review,0,0,0,1,0,0,1
dinoburgers,0,0,0,1,0,0,1
treatise,0,0,0,1,0,0,1
junkion,0,0,0,1,0,0,1
grimlock,0,0,0,1,0,0,1
breen,0,0,0,1,0,0,1
kup,0,0,0,1,0,0,1
perceptor,0,0,0,1,0,0,1
castoffs,0,0,0,1,0,0,1
experimental,0,0,0,1,0,0,1
exercise,0,0,0,1,0,0,1
martians,0,0,0,1,0,0,1
quatermass,0,0,0,1,0,0,1
breen's,0,0,0,1,0,0,1
astaire,0,0,0,1,0,0,1
the arctic ocean,0,0,0,1,0,0,1
disappear,0,0,0,1,0,0,1
transistor,0,0,0,1,0,0,1
|publisher2002,0,0,0,1,0,0,1
the salvation army,0,0,0,1,0,0,1
cola,0,0,0,1,0,0,1
interlude,0,0,0,1,0,0,1
periscope,0,0,0,1,0,0,1
connecticut,0,0,0,1,0,0,1
swordfish,0,0,0,1,0,0,1
quintesson,0,0,0,1,0,0,1
the gulf of alaska,0,0,0,1,0,0,1
rodimus,0,0,0,1,0,0,1
"blurr, springer, perceptor",0,0,0,1,0,0,1
barrow,0,0,0,1,0,0,1
sawfish,0,0,0,1,0,0,1
alaska,0,0,0,1,0,0,1
judd,0,0,0,1,0,0,1
junk,0,0,0,1,0,0,1
hobbs,0,0,0,1,0,0,1
arcee,0,0,0,1,0,0,1
hob,0,0,0,1,0,0,1
colonisation,0,0,0,1,0,0,1
astrotrain,0,0,0,1,0,0,1
v,0,0,0,1,0,0,1
primeval,0,0,0,1,0,0,1
psyche,0,0,0,1,0,0,1
wreck-gar,0,0,0,1,0,0,1
scourge,0,0,0,1,0,0,1
uncovers,0,0,0,1,0,0,1
vestige,0,0,0,1,0,0,1
cliffjumper,0,0,0,1,0,0,1
sit,0,0,0,1,0,0,1
purge,0,0,0,1,0,0,1
apemen,0,0,0,1,0,0,1
cyclonus,0,0,0,1,0,0,1
roney,0,0,0,1,0,0,1
sladden,0,0,0,1,0,0,1
sweeps,0,0,0,1,0,0,1
autobot,0,0,0,1,0,0,1
staging,0,0,0,1,0,0,1
physiology,0,0,0,1,0,0,1
homeworld,0,0,0,1,0,0,1
arbulus,0,0,0,1,0,0,1
sharkticons,0,0,0,1,0,0,1
witwicky,0,0,0,1,0,0,1
decepticon,0,0,0,1,0,0,1
interference,0,0,0,1,0,0,1
gregory,0,0,0,1,0,0,1
decepticons,0,0,0,1,0,0,1
royal australian navy,0,0,0,1,0,0,1
blurr,0,0,0,1,0,0,1
tierra,0,0,0,1,0,0,1
dinobots,0,0,0,1,0,0,1
megatron,0,0,0,1,0,0,1
diego,0,0,0,1,0,0,1
brunette,0,0,0,1,0,0,1
likelihood,0,0,0,1,0,0,1
integrity,0,0,0,1,0,0,1
fail,0,0,0,1,0,0,1
fail-safe,0,0,0,1,0,0,1
windegger,0,0,0,1,0,0,1
visionary,0,0,0,1,0,0,1
friede,0,0,0,1,0,0,1
coca cola,0,0,0,1,0,0,1
confidant,0,0,0,1,0,0,1
entrepreneur,0,0,0,1,0,0,1
hemisphere,0,0,0,1,0,0,1
coward,0,0,0,1,0,0,1
towers,0,0,0,1,0,0,1
twenty,0,0,0,1,0,0,1
helius toward friede,0,0,0,1,0,0,1
lucidity,0,0,0,1,0,0,1
crevasse,0,0,0,1,0,0,1
point barrow,0,0,0,1,0,0,1
mannfeldt,0,0,0,1,0,0,1
coca,0,0,0,1,0,0,1
ferrari,0,0,0,1,0,0,1
davidson,0,0,0,1,0,0,1
guardsman,0,0,0,1,0,0,1
moira,0,0,0,1,0,0,1
shute,0,0,0,1,0,0,1
nevil,0,0,0,1,0,0,1
autobot city,0,0,0,1,0,0,1
kranix,0,0,0,1,0,0,1
springer,0,0,0,1,0,0,1
hosgood,0,0,0,1,0,0,1
galvatron,0,0,0,1,0,0,1
ultra magnus,0,0,0,1,0,0,1
sentencing,0,0,0,1,0,0,1
world war iii,0,0,0,1,0,0,1
lithone,0,0,0,1,0,0,1
tea,0,0,0,1,0,0,1
buildings,0,0,0,1,0,0,1
lookout mountain,0,0,0,1,0,0,1
melbourne,0,0,0,1,0,0,1
quintessons,0,0,0,1,0,0,1
bridie,0,0,0,1,0,0,1
gar,0,0,0,1,0,0,1
the southern hemisphere,0,0,0,1,0,0,1
submariner,0,0,0,1,0,0,1
submerges,0,0,0,1,0,0,1
dwight,0,0,0,1,0,0,1
montevideo,0,0,0,1,0,0,1
osborne,0,0,0,1,0,0,1
transformers,0,0,0,1,0,0,1
fuego,0,0,0,1,0,0,1
unicron,0,0,0,1,0,0,1
"the ""australian grand prix",0,0,0,1,0,0,1
southernmost,0,0,0,1,0,0,1
autobots jazz,0,0,0,1,0,0,1
borazon,0,0,0,1,0,0,1
hobbs end,0,0,0,1,0,0,1
tinker,0,0,0,1,0,0,1
asha,0,0,0,1,0,0,1
chequamegon,0,0,0,1,0,0,1
chequamegon bay,0,0,0,1,0,0,1
kekoa,0,0,0,1,0,0,1
khal,0,0,0,1,0,0,1
encryption,0,0,0,1,0,0,1
tonight,0,0,0,1,0,0,1
griffin,0,0,0,1,0,0,1
ledger,1,0,0,0,0,0,1
goonbots,0,0,0,1,0,0,1
biehl,0,0,0,1,0,0,1
mint,0,0,0,1,0,0,1
seti,0,0,0,1,0,0,1
lincoln penny,0,0,0,1,0,0,1
voyager,0,0,0,1,0,0,1
sweat,0,0,0,1,0,0,1
mckenna,0,0,0,1,0,0,1
gestation,0,0,0,1,0,0,1
shermin,0,0,0,1,0,0,1
stable,0,0,0,1,0,0,1
hayden,0,0,0,1,0,0,1
barringer,0,0,0,1,0,0,1
stroll,0,0,0,1,0,0,1
slot,0,0,0,1,0,0,1
starman,0,0,0,1,0,0,1
syntax,0,0,0,1,0,0,1
barringer crater,0,0,0,1,0,0,1
hiking,0,0,0,1,0,0,1
sixth,0,0,0,1,0,0,1
fort hancock,1,0,0,0,0,0,1
westlake,0,0,0,1,0,0,1
millie,0,0,0,1,0,0,1
unreferenced|section|datedifferences,0,0,0,1,0,0,1
cupboard,0,0,0,1,0,0,1
dark doings proliferate in a world,0,0,0,1,0,0,1
animeby,0,0,0,1,0,0,1
remake,0,0,0,1,0,0,1
serenity,0,0,0,1,0,0,1
vivid,0,0,0,1,0,0,1
kenichi,0,0,0,1,0,0,1
doings,0,0,0,1,0,0,1
o.,0,0,0,1,0,0,1
printing,0,0,0,1,0,0,1
corkscrew,0,0,0,1,0,0,1
causality,0,0,0,1,0,0,1
kenichi & tima robot company,0,0,0,1,0,0,1
pee,0,0,0,1,0,0,1
|urlfilm,0,0,0,1,0,0,1
firefly and/or serenity,0,0,0,1,0,0,1
colors,0,0,0,1,0,0,1
manga,0,0,0,1,0,0,1
proliferate,0,0,0,1,0,0,1
rewinds,0,0,0,1,0,0,1
jude,0,0,0,1,0,0,1
malita,0,0,0,1,0,0,1
tima,0,0,0,1,0,0,1
lavond,0,0,0,1,0,0,1
trixi,0,0,0,1,0,0,1
jackpot,0,0,0,1,0,0,1
bellhop,0,0,0,1,0,0,1
british experimental rocket group,0,0,0,1,0,0,1
energon,0,0,0,1,0,0,1
ming,0,0,0,1,0,0,1
the shark men,0,0,0,1,0,0,1
claws,0,0,0,1,0,0,1
unseen,0,0,0,1,0,0,1
junkions,0,0,0,1,0,0,1
kala,0,0,0,1,0,0,1
wikia&nbsp,0,0,0,1,0,0,1
wheelie,0,0,0,1,0,0,1
transform,0,0,0,1,0,0,1
reclaim,0,0,0,1,0,0,1
mongo,0,0,0,1,0,0,1
king vultan,0,0,0,1,0,0,1
starscream,0,0,0,1,0,0,1
optimus,0,0,0,1,0,0,1
underling,0,0,0,1,0,0,1
earth&nbsp,0,0,0,1,0,0,1
bumblebee,0,0,0,1,0,0,1
the lion men,0,0,0,1,0,0,1
zarkov,0,0,0,1,0,0,1
ultra,0,0,0,1,0,0,1
hawkmen,0,0,0,1,0,0,1
thun,0,0,0,1,0,0,1
cybertron,0,0,0,1,0,0,1
vultan,0,0,0,1,0,0,1
palaeontologist,0,0,0,1,0,0,1
hauntings,0,0,0,1,0,0,1
autobots,0,0,0,1,0,0,1
the tunnel of terror,0,0,0,1,0,0,1
shark men,0,0,0,1,0,0,1
fawcett,0,0,0,1,0,0,1
barin,0,0,0,1,0,0,1
wisconsin,0,0,0,1,0,0,1
norad,0,0,0,1,0,0,1
dormeur,0,0,0,1,0,0,1
collier,0,0,0,1,0,0,1
oscar,0,0,0,1,0,0,1
merde,0,0,0,1,0,0,1
more.{{allrovi,0,0,0,1,0,0,1
soundstage,0,0,0,1,0,0,1
kylie,0,0,0,1,0,0,1
gerard,0,0,0,1,0,0,1
monsieur,0,0,0,1,0,0,1
finney,0,0,0,1,0,0,1
quintessa,0,0,0,1,0,0,1
minogue,0,0,0,1,0,0,1
carax,0,0,0,1,0,0,1
jaunt,0,0,0,1,0,0,1
céline,0,0,0,1,0,0,1
vidor,0,0,0,1,0,0,1
octosak,0,0,0,1,0,0,1
alexis,0,0,0,1,0,0,1
#,0,0,0,1,0,0,1
tigron,0,0,0,1,0,0,1
the claws of the tigron #: zarkov,0,0,0,1,0,0,1
furnaces,0,0,0,1,0,0,1
arden,0,0,0,1,0,0,1
orangopoid,0,0,0,1,0,0,1
destroying,0,0,0,1,0,0,1
pi,0,0,0,1,0,0,1
superfortress,1,0,0,0,0,0,1
the bank of el paso,0,0,0,0,1,0,1
hospitality,0,0,0,0,0,1,1
south seas,0,0,0,0,0,1,1
vivisection,0,0,0,0,0,1,1
lota,0,0,0,0,0,1,1
ouran,0,0,0,0,0,1,1
sayer,0,0,0,0,0,1,1
m'ling,0,0,0,0,0,1,1
mistreating,0,0,0,0,0,1,1
whip,0,0,0,0,0,1,1
seas,0,0,0,0,0,1,1
hurst,0,0,0,0,0,1,1
"sidney, tatum",0,0,0,0,0,1,1
riley,0,0,0,0,0,1,1
randy,0,0,0,0,0,1,1
prescott,0,0,0,0,0,1,1
weathers,0,0,0,0,0,1,1
himbry,0,0,0,0,0,1,1
"sidney, billy, stu",0,0,0,0,0,1,1
panther,0,0,0,0,0,1,1
fields,0,0,0,0,0,1,1
vaccine,0,0,0,0,0,1,1
moreau,0,0,0,0,0,1,1
indie,0,0,0,0,0,1,1
screenwriter,0,0,0,0,0,1,1
”mario,0,0,0,0,0,1,1
indie horror gallery,0,0,0,0,0,1,1
fearzone.com,0,0,0,0,0,1,1
quit,0,0,0,0,0,1,1
blood!dr,0,0,0,0,0,1,1
reviews,0,0,0,0,0,1,1
lights,0,0,0,0,0,1,1
aboard,0,0,0,0,0,1,1
strangulation,0,0,0,0,0,1,1
seward,0,0,0,0,0,1,1
carfax,0,0,0,0,0,1,1
carfax abbey,0,0,0,0,0,1,1
lucia,0,0,0,0,0,1,1
apia,0,0,0,0,0,1,1
donahue,0,0,0,0,0,1,1
kenny,0,0,0,0,0,1,1
casey,0,0,0,0,0,1,1
stu,0,0,0,0,0,1,1
loomis,0,0,0,0,0,1,1
naturan,0,0,0,0,0,1,1
demanto,0,0,0,0,0,1,1
wrestle,0,0,0,0,0,1,1
backdoor,0,0,0,0,0,1,1
crevice,0,0,0,0,0,1,1
shelly,0,0,0,0,0,1,1
cheryl,0,0,0,0,0,1,1
michigan state,0,0,0,0,0,1,1
scotty,0,0,0,0,0,1,1
rec,0,0,0,0,0,1,1
ángela,0,0,0,0,0,1,1
stairwell,0,0,0,0,0,1,1
textile,0,0,0,0,0,1,1
ángela vidal,0,0,0,0,0,1,1
virulent,0,0,0,0,0,1,1
the girl medeiros,0,0,0,0,0,1,1
medeiros,0,0,0,0,0,1,1
jon,0,0,0,0,0,1,1
reelection,0,0,0,0,0,1,1
rove,0,0,0,0,0,1,1
cindy,0,0,0,0,0,1,1
becker,0,0,0,0,0,1,1
tatum,0,0,0,0,0,1,1
macher,0,0,0,0,0,1,1
sidney,0,0,0,0,0,1,1
dewey,0,0,0,0,0,1,1
meeks,0,0,0,0,0,1,1
murch,0,0,0,0,0,1,1
the civil war,0,0,0,0,0,1,1
hofstader,0,0,0,0,0,1,1
cleaver,0,0,0,0,0,1,1
sexpot,0,0,0,0,0,1,1
tenney,0,0,0,0,0,1,1
world war i and ii,0,0,0,0,0,1,1
the united states of america,0,0,0,0,0,1,1
handling,0,0,0,0,0,1,1
sheehan,0,0,0,0,0,1,1
masterpiece,0,0,0,0,0,1,1
groupie,0,0,0,0,0,1,1
orgy,0,0,0,0,0,1,1
miscarries,0,0,0,0,0,1,1
papillon,0,0,0,0,0,1,1
apollo,0,0,0,0,0,1,1
daae,0,0,0,0,0,1,1
composition,0,0,0,0,0,1,1
marguerite,0,0,0,0,0,1,1
megiddo,0,0,0,0,0,1,1
brennan,0,0,0,0,0,1,1
warner,0,0,0,0,0,1,1
satani,0,0,0,0,0,1,1
baylock,0,0,0,0,0,1,1
benson,0,0,0,0,0,1,1
six,0,0,0,0,0,1,1
spiletto,0,0,0,0,0,1,1
katherine,0,0,0,0,0,1,1
rottweiler,0,0,0,0,0,1,1
ave,0,0,0,0,0,1,1
carving,0,0,0,0,0,1,1
seine,0,0,0,0,0,1,1
the opera ghost,0,0,0,0,0,1,1
vicomte,0,0,0,0,0,1,1
reissue,0,0,0,0,0,1,1
gounod,0,0,0,0,0,1,1
the vicomte raoul de chagny,0,0,0,0,0,1,1
donna,0,0,0,0,0,1,1
the paris opera house,0,0,0,0,0,1,1
ovation,0,0,0,0,0,1,1
mme,0,0,0,0,0,1,1
paris grand opera,0,0,0,0,0,1,1
erik/phantom,0,0,0,0,0,1,1
the edgar allan poe,0,0,0,0,0,1,1
ledoux,0,0,0,0,0,1,1
grasshopper,0,0,0,0,0,1,1
prima,0,0,0,0,0,1,1
buquet,0,0,0,0,0,1,1
comte,0,0,0,0,0,1,1
the seine river,0,0,0,0,0,1,1
trapdoor,0,0,0,0,0,1,1
bugenhagen,0,0,0,0,0,1,1
jackal,0,0,0,0,0,1,1
rocky,0,0,0,0,0,1,1
concha,0,0,0,0,0,1,1
criminologist,0,0,0,0,0,1,1
furter,0,0,0,0,0,1,1
transsexual,0,0,0,0,0,1,1
cabaret,0,0,0,0,0,1,1
riff,0,0,0,0,0,1,1
transducer,0,0,0,0,0,1,1
transylvanians,0,0,0,0,0,1,1
weiss,0,0,0,0,0,1,1
magenta,0,0,0,0,0,1,1
transvestite,0,0,0,0,0,1,1
transylvanian,0,0,0,0,0,1,1
annual,0,0,0,0,0,1,1
everett,0,0,0,0,0,1,1
"scott, frank suspects",0,0,0,0,0,1,1
raff,0,0,0,0,0,1,1
majors,0,0,0,0,0,1,1
medusa,0,0,0,0,0,1,1
spiritualist,0,0,0,0,0,1,1
fane,0,0,0,0,0,1,1
ferdinand,0,0,0,0,0,1,1
mannequin,0,0,0,0,0,1,1
down syndrome,0,0,0,0,0,1,1
plot|dateflashbackflash,0,0,0,0,0,1,1
throw,0,0,0,0,0,1,1
aladin,0,0,0,0,0,1,1
fenix,0,0,0,0,0,1,1
the tattooed woman,0,0,0,0,0,1,1
knitting,0,0,0,0,0,1,1
tattooed,0,0,0,0,0,1,1
elvery,0,0,0,0,0,1,1
orgo,0,0,0,0,0,1,1
navigation,0,0,0,0,0,1,1
crocodile,0,0,0,0,0,1,1
marks,0,0,0,0,0,1,1
connors,0,0,0,0,0,1,1
guests,0,0,0,0,0,1,1
ferdinand fane,0,0,0,0,0,1,1
barcelona,0,0,0,0,0,1,1
evil ash,0,0,0,0,0,1,1
tuition,0,0,0,0,0,1,1
todd,0,0,0,0,0,1,1
kettle,0,0,0,0,0,1,1
flat,0,0,0,0,0,1,1
sanders,0,0,0,0,0,1,1
pedal,0,0,0,0,0,1,1
bakehouse,0,0,0,0,0,1,1
davy,0,0,0,0,0,1,1
turpin,0,0,0,0,0,1,1
prospers,0,0,0,0,0,1,1
beadle,0,0,0,0,0,1,1
tonic,0,0,0,0,0,1,1
faux-italian,0,0,0,0,0,1,1
pirelli,0,0,0,0,0,1,1
tobias,0,0,0,0,0,1,1
bamford,0,0,0,0,0,1,1
barbering,0,0,0,0,0,1,1
shave,0,0,0,0,0,1,1
fogg,0,0,0,0,0,1,1
aristocracy,0,0,0,0,0,1,1
collins,0,0,0,0,0,1,1
flying deadite,0,0,0,0,0,1,1
beadle bamford,0,0,0,0,0,1,1
mattress,0,0,0,0,0,1,1
ema,0,0,0,0,0,1,1
gorgeous,0,0,0,0,0,1,1
upset,0,0,0,0,0,1,1
watermelon,0,0,0,0,0,1,1
spurt,0,0,0,0,0,1,1
prof,0,0,0,0,0,1,1
buttock,0,0,0,0,0,1,1
kung,0,0,0,0,0,1,1
bridal,0,0,0,0,0,1,1
"prof, fantasy",0,0,0,0,0,1,1
morphs,0,0,0,0,0,1,1
carabanchel,0,0,0,0,0,1,1
basque,0,0,0,0,0,1,1
adolfo,0,0,0,0,0,1,1
chimney,0,0,0,0,0,1,1
johanna,0,0,0,0,0,1,1
"beadle, turpin",0,0,0,0,0,1,1
ragg,0,0,0,0,0,1,1
boiling,0,0,0,0,0,1,1
nellie,0,0,0,0,0,1,1
sang,0,0,0,0,0,1,1
moose,0,0,0,0,0,1,1
matson,0,0,0,0,0,1,1
ferdie,0,0,0,0,0,1,1
the andrews sisters,0,0,0,0,0,1,1
chez glamour,0,0,0,0,0,1,1
stammer,0,0,0,0,0,1,1
forrester's club,0,0,0,0,0,1,1
wildcat,0,0,0,0,0,1,1
servicing,0,0,0,0,0,1,1
inherit,0,0,0,0,0,1,1
ferbie,0,0,0,0,0,1,1
shake,0,0,0,0,0,1,1
ted,0,0,0,0,0,1,1
glamour,0,0,0,0,0,1,1
vicomtess,0,0,0,0,0,1,1
dominates,0,0,0,0,0,1,1
si,0,0,0,0,0,1,1
reburial,0,0,0,0,0,1,1
chau,0,0,0,0,0,1,1
talbot,0,0,0,0,0,1,1
slab,0,0,0,0,0,1,1
disconnect,0,0,0,0,0,1,1
"the ""mcdougal house of horrors",0,0,0,0,0,1,1
pillory,0,0,0,0,0,1,1
impatient,0,0,0,0,0,1,1
leighos,0,0,0,0,0,1,1
horrors,0,0,0,0,0,1,1
credential,0,0,0,0,0,1,1
kau,0,0,0,0,0,1,1
crank,0,0,0,0,0,1,1
wilbur,0,0,0,0,0,1,1
the frankenstein monster,0,0,0,0,0,1,1
mcdougal,0,0,0,0,0,1,1
close,0,0,0,0,0,1,1
i.d.,0,0,0,0,0,1,1
geung,0,0,0,0,0,1,1
gown,0,0,0,0,0,1,1
peltzer,0,0,0,0,0,1,1
gremlins,0,0,0,0,0,1,1
lo,0,0,0,0,0,1,1
tree demoness,0,0,0,0,0,1,1
chik,0,0,0,0,0,1,1
hesitates,0,0,0,0,0,1,1
tina,0,0,0,0,0,1,1
krueger,0,0,0,0,0,1,1
technicality,0,0,0,0,0,1,1
freddy,0,0,0,0,0,1,1
nancy,0,0,0,0,0,1,1
clamp,0,0,0,0,0,1,1
sweater,0,0,0,0,0,1,1
glen,0,0,0,0,0,1,1
freddy pull marge,0,0,0,0,0,1,1
slash,0,0,0,0,0,1,1
nightgown,0,0,0,0,0,1,1
marge,0,0,0,0,0,1,1
lantz,0,0,0,0,0,1,1
dreamworld,0,0,0,0,0,1,1
crest,0,0,0,0,0,1,1
nip,0,0,0,0,0,1,1
ning buries nip's,0,0,0,0,0,1,1
s-mart,0,0,0,0,0,1,1
oldsmobile delta 88,0,0,0,0,0,1,1
klaatu,0,0,0,0,0,1,1
mart,0,0,0,0,0,1,1
verata,0,0,0,0,0,1,1
the necronomicon ex-mortis,0,0,0,0,0,1,1
sheila,0,0,0,0,0,1,1
deadites,0,0,0,0,0,1,1
medieval,0,0,0,0,0,1,1
ha,0,0,0,0,0,1,1
s,0,0,0,0,0,1,1
the army of darkness,0,0,0,0,0,1,1
duke henry,0,0,0,0,0,1,1
the tree demoness,0,0,0,0,0,1,1
joss,0,0,0,0,0,1,1
buries,0,0,0,0,0,1,1
demoness,0,0,0,0,0,1,1
fei,0,0,0,0,0,1,1
maltreatment,0,0,0,0,0,1,1
mogwai,0,0,0,0,0,1,1
wardrobe,0,0,0,0,0,1,1
suzy,0,0,0,0,0,1,1
olga,0,0,0,0,0,1,1
tanner,0,0,0,0,0,1,1
dormitory,0,0,0,0,0,1,1
kingston,0,0,0,0,0,1,1
gremlin,0,0,0,0,0,1,1
dwarfs,0,0,0,0,0,1,1
beringer,0,0,0,0,0,1,1
gizmo,0,0,0,0,0,1,1
hanson,0,0,0,0,0,1,1
peltzers,0,0,0,0,0,1,1
cocoon,0,0,0,0,0,1,1
quiff,0,0,0,0,0,1,1
sandwich,0,0,0,0,0,1,1
montgomery ward,0,0,0,0,0,1,1
stripe,0,0,0,0,0,1,1
kingston falls,0,0,0,0,0,1,1
iris,0,0,0,0,0,1,1
hingle,0,0,0,0,0,1,1
snore,0,0,0,0,0,1,1
blanc offers suzy,0,0,0,0,0,1,1
lei,0,0,0,0,0,1,1
extremity,0,0,0,0,0,1,1
weirdo,0,0,0,0,0,1,1
swim,0,0,0,0,0,1,1
mandel,0,0,0,0,0,1,1
émigré,0,0,0,0,0,1,1
mumbling,0,0,0,0,0,1,1
"blanc, tanner",0,0,0,0,0,1,1
drowsy,0,0,0,0,0,1,1
psychologist,0,0,0,0,0,1,1
whistling,0,0,0,0,0,1,1
freiburg,0,0,0,0,0,1,1
millus,0,0,0,0,0,1,1
markos,0,0,0,0,0,1,1
munich,0,0,0,0,0,1,1
banyon,0,0,0,0,0,1,1
florine,0,0,0,0,0,1,1
stagehand,0,0,0,0,0,1,1
snowcat,0,0,0,0,0,1,1
ga,0,0,0,0,0,1,1
kyung,0,0,0,0,0,1,1
joong,0,0,0,0,0,1,1
forewarning,0,0,0,0,0,1,1
"ann, kong",0,0,0,0,0,1,1
englehorn,0,0,0,0,0,1,1
wear,0,0,0,0,0,1,1
fella,0,0,0,0,0,1,1
denham,0,0,0,0,0,1,1
darrow,0,0,0,0,0,1,1
sneer,0,0,0,0,0,1,1
weston,0,0,0,0,0,1,1
the eighth wonder of the world,0,0,0,0,0,1,1
plesiosaurus,0,0,0,0,0,1,1
brontosaurus,0,0,0,0,0,1,1
marquee,0,0,0,0,0,1,1
gala,0,0,0,0,0,1,1
eighth,0,0,0,0,0,1,1
misshapen,0,0,0,0,0,1,1
yong,0,0,0,0,0,1,1
national guardsmen,0,0,0,0,0,1,1
kim,0,0,0,0,0,1,1
bramford,0,0,0,0,0,1,1
chocolate,0,0,0,0,0,1,1
eun,0,0,0,0,0,1,1
jung-sun,0,0,0,0,0,1,1
eun-kyung,0,0,0,0,0,1,1
korea,0,0,0,0,0,1,1
yun,0,0,0,0,0,1,1
jee-sun's,0,0,0,0,0,1,1
jee-sun,0,0,0,0,0,1,1
ga-in,0,0,0,0,0,1,1
ga-yun,0,0,0,0,0,1,1
hwang,0,0,0,0,0,1,1
jee,0,0,0,0,0,1,1
jung-sun's,0,0,0,0,0,1,1
min,0,0,0,0,0,1,1
suk,0,0,0,0,0,1,1
ga-in's,0,0,0,0,0,1,1
ann,0,0,0,0,0,1,1
stegosaurus,0,0,0,0,0,1,1
driscoll,0,0,0,0,0,1,1
peninsula,0,0,0,0,0,1,1
winchester,0,0,0,0,0,1,1
hungover,0,0,0,0,0,1,1
unbolts,0,0,0,0,0,1,1
housemate,0,0,0,0,0,1,1
the british army,0,0,0,0,0,1,1
crackheads,0,0,0,0,0,1,1
reed,0,0,0,0,0,1,1
hachi,0,0,0,0,0,1,1
o,0,0,0,0,0,1,1
the u.s. government,0,0,0,0,0,1,1
foreshadowing,0,0,0,0,0,1,1
mutagen,0,0,0,0,0,1,1
horrorexpress.com,0,0,0,0,0,1,1
the living dead,0,0,0,0,0,1,1
wgon,0,0,0,0,0,1,1
francine,0,0,0,0,0,1,1
begay,1,0,0,0,0,0,1
dianne,0,0,0,0,0,1,1
electro,0,0,0,0,0,1,1
spending,0,0,0,0,0,1,1
wisborg,0,0,0,0,0,1,1
tyrannosaurus,0,0,0,0,0,1,1
islander,0,0,0,0,0,1,1
coachman,0,0,0,0,0,1,1
hutter,0,0,0,0,0,1,1
logbook,0,0,0,0,0,1,1
puff,0,0,0,0,0,1,1
the carpathian mountains,0,0,0,0,0,1,1
rooster,0,0,0,0,0,1,1
shaun,0,0,0,0,0,1,1
prowl,0,0,0,0,0,1,1
multitude,0,0,0,0,0,1,1
carpathian,0,0,0,0,0,1,1
son.{{cite,1,0,0,0,0,0,1
the navajo nation,1,0,0,0,0,0,1
puncture,0,0,0,0,0,1,1
bulwer,0,0,0,0,0,1,1
castavets,0,0,0,0,0,1,1
marcato,0,0,0,0,0,1,1
sapirstein,0,0,0,0,0,1,1
kinderman,0,0,0,0,0,1,1
moanna,0,0,0,0,0,1,1
captain vidal,0,0,0,0,0,1,1
contraction,0,0,0,0,0,1,1
ofelia,0,0,0,0,0,1,1
pale,0,0,0,0,0,1,1
disobedience,0,0,0,0,0,1,1
faun,0,0,0,0,0,1,1
pedro,0,0,0,0,0,1,1
belly,0,0,0,0,0,1,1
post-civil war spain,0,0,0,0,0,1,1
trace,0,0,0,0,0,1,1
"washington, dc",0,0,0,0,0,1,1
merrin,0,0,0,0,0,1,1
lankester,0,0,0,0,0,1,1
dennings,0,0,0,0,0,1,1
dyer,0,0,0,0,0,1,1
macneil,0,0,0,0,0,1,1
falangism,0,0,0,0,0,1,1
morocco,0,0,0,0,0,1,1
spill,0,0,0,0,0,1,1
reveler,0,0,0,0,0,1,1
wendy,0,0,0,0,0,1,1
hedge,0,0,0,0,0,1,1
lloyd .,0,0,0,0,0,1,1
slur,0,0,0,0,0,1,1
lipstick,0,0,0,0,0,1,1
snowfall,0,0,0,0,0,1,1
premonition,0,0,0,0,0,1,1
overlook,0,0,0,0,0,1,1
esp,0,0,0,0,0,1,1
king's,0,0,0,0,0,1,1
redrum,0,0,0,0,0,1,1
it,0,0,0,0,0,1,1
"murdǝя""",0,0,0,0,0,1,1
torrance,0,0,0,0,0,1,1
"tony"".{{anchor",0,0,0,0,0,1,1
americanhallorann,0,0,0,0,0,1,1
burke dennings,0,0,0,0,0,1,1
dc,0,0,0,0,0,1,1
mousse,0,0,0,0,0,1,1
karras,0,0,0,0,0,1,1
horrifies,0,0,0,0,0,1,1
castevet,0,0,0,0,0,1,1
intercourse,0,0,0,0,0,1,1
vitamin,0,0,0,0,0,1,1
congregation,0,0,0,0,0,1,1
obstetrician,0,0,0,0,0,1,1
cardiff,0,0,0,0,0,1,1
mouthful,0,0,0,0,0,1,1
woodhouse,0,0,0,0,0,1,1
hutch,0,0,0,0,0,1,1
fragrance,0,0,0,0,0,1,1
rosemary,0,0,0,0,0,1,1
evans,0,0,0,0,0,1,1
steven,0,0,0,0,0,1,1
liver,0,0,0,0,0,1,1
gionoffrio,0,0,0,0,0,1,1
ramekin,0,0,0,0,0,1,1
the year one,0,0,0,0,0,1,1
minnie,0,0,0,0,0,1,1
roman castevet,0,0,0,0,0,1,1
northern iraq,0,0,0,0,0,1,1
lesion,0,0,0,0,0,1,1
cpr,0,0,0,0,0,1,1
handwriting,0,0,0,0,0,1,1
georgetown university,0,0,0,0,0,1,1
regan,0,0,0,0,0,1,1
lobe,0,0,0,0,0,1,1
administers,0,0,0,0,0,1,1
georgetown,0,0,0,0,0,1,1
anagram,0,0,0,0,0,1,1
psychosis,0,0,0,0,0,1,1
viaticum,0,0,0,0,0,1,1
gustafsson,0,0,0,0,0,1,1
holm,0,0,0,0,0,1,1
salvation army,0,0,0,0,0,1,1
georges,0,0,0,0,0,1,1
castevets,0,0,0,0,0,1,1
african american,0,0,0,0,0,1,1
alternate,0,0,0,0,0,1,1
juno,0,0,0,0,0,1,1
meier,0,0,0,0,0,1,1
shifter,0,0,0,0,0,1,1
mashira,0,0,0,0,0,1,1
chaythe,0,0,0,0,0,1,1
the castle of chaythe,0,0,0,0,0,1,1
natsue,0,0,0,0,0,1,1
heita,0,0,0,0,0,1,1
sanpei,0,0,0,0,0,1,1
takako,0,0,0,0,0,1,1
natsu,0,0,0,0,0,1,1
inland,0,0,0,0,0,1,1
hiroshima,0,0,0,0,0,1,1
dines,0,0,0,0,0,1,1
iwakichi,0,0,0,0,0,1,1
kindergarten,0,0,0,0,0,1,1
midwife,0,0,0,0,0,1,1
piccadilly,0,0,0,0,0,1,1
lupine,0,0,0,0,0,1,1
carmilla,0,0,0,0,0,1,1
the city of the night,0,0,0,0,0,1,1
habitation,0,0,0,0,0,1,1
countess,0,0,0,0,0,1,1
infected,0,0,0,0,0,1,1
banishment,0,0,0,0,0,1,1
anne,0,0,0,0,0,1,1
duchess,0,0,0,0,0,1,1
laughs,0,0,0,0,0,1,1
king james ii,0,0,0,0,0,1,1
ursus,0,0,0,0,0,1,1
gwynplaine,0,0,0,0,0,1,1
josiana,0,0,0,0,0,1,1
hardquannone,0,0,0,0,0,1,1
leila,0,0,0,0,0,1,1
benge,0,0,0,0,0,1,1
barbarois,0,0,0,0,0,1,1
cloyd,1,0,0,0,0,0,1
bloodlust,0,0,0,0,0,1,1
supreme within,0,0,0,0,0,1,1
caroline,0,0,0,0,0,1,1
moor,0,0,0,0,0,1,1
"alex, david",0,0,0,0,0,1,1
londoners,0,0,0,0,0,1,1
pubgoer,0,0,0,0,0,1,1
maitland,0,0,0,0,0,1,1
pastel,0,0,0,0,0,1,1
goth,0,0,0,0,0,1,1
roadway,0,0,0,0,0,1,1
betelgeuse,0,0,0,0,0,1,1
crude,0,0,0,0,0,1,1
maitlands,0,0,0,0,0,1,1
beetlejuice,0,0,0,0,0,1,1
delia,0,0,0,0,0,1,1
deceased,0,0,0,0,0,1,1
saturn,0,0,0,0,0,1,1
sandworms,0,0,0,0,0,1,1
séance,0,0,0,0,0,1,1
sandworm,0,0,0,0,0,1,1
maxie,0,0,0,0,0,1,1
otho,0,0,0,0,0,1,1
recently,0,0,0,0,0,1,1
lydia,0,0,0,0,0,1,1
handbook,0,0,0,0,0,1,1
deetzes,0,0,0,0,0,1,1
maniac,0,0,0,0,0,1,1
hirsch,0,0,0,0,0,1,1
alex's,0,0,0,0,0,1,1
bumbling,0,0,0,0,0,1,1
lad,0,0,0,0,0,1,1
sinister,0,0,0,0,0,1,1
slaughtered,0,0,0,0,0,1,1
zoo,0,0,0,0,0,1,1
kessler,0,0,0,0,0,1,1
yorkshire,0,0,0,0,0,1,1
pubgoers,0,0,0,0,0,1,1
villiers,0,0,0,0,0,1,1
the slaughtered lamb,0,0,0,0,0,1,1
mcmanus,0,0,0,0,0,1,1
piccadilly circus,0,0,0,0,0,1,1
bye,0,0,0,0,0,1,1
mauling,0,0,0,0,0,1,1
hummer,0,0,0,0,0,1,1
wichita,0,0,0,0,0,1,1
krista,0,0,0,0,0,1,1
archeology,0,0,0,0,0,1,1
grows,0,0,0,0,0,1,1
eli,0,0,0,0,0,1,1
conny,0,0,0,0,0,1,1
håkan,0,0,0,0,0,1,1
pus,0,0,0,0,0,1,1
blackeberg,0,0,0,0,0,1,1
fourth,0,0,0,0,0,1,1
fitness,0,0,0,0,0,1,1
ávila,0,0,0,0,0,1,1
peek,0,0,0,0,0,1,1
gösta,0,0,0,0,0,1,1
jocke,0,0,0,0,0,1,1
alonzo,0,0,0,0,0,1,1
zanzi,0,0,0,0,0,1,1
treadmill,0,0,0,0,0,1,1
cojo,0,0,0,0,0,1,1
nanon,0,0,0,0,0,1,1
makeshift,0,0,0,0,0,1,1
waylays,0,0,0,0,0,1,1
genitalia,0,0,0,0,0,1,1
masonry,0,0,0,0,0,1,1
infrequent,0,0,0,0,0,1,1
operative,0,0,0,0,0,1,1
bikers,0,0,0,0,0,1,1
appliance,0,0,0,0,0,1,1
pandemic,0,0,0,0,0,1,1
reanimates,0,0,0,0,0,1,1
broadcaster,0,0,0,0,0,1,1
deathtrap,0,0,0,0,0,1,1
lacke,0,0,0,0,0,1,1
barbra,0,0,0,0,0,1,1
contamination,0,0,0,0,0,1,1
experts,0,0,0,0,0,1,1
trowel,0,0,0,0,0,1,1
hydrochloric,0,0,0,0,0,1,1
threshold,0,0,0,0,0,1,1
spilt,0,0,0,0,0,1,1
henrietta,0,0,0,0,0,1,1
kandarian,0,0,0,0,0,1,1
leisure,0,0,0,0,0,1,1
knowby,0,0,0,0,0,1,1
telepods,0,0,0,0,0,1,1
borans,0,0,0,0,0,1,1
particle,0,0,0,0,0,1,1
quaife,0,0,0,0,0,1,1
enzyme,0,0,0,0,0,1,1
telepod,0,0,0,0,0,1,1
chunk,0,0,0,0,0,1,1
baboon,0,0,0,0,0,1,1
little rock for pacific,0,0,0,0,0,1,1
playland,0,0,0,0,0,1,1
little rock's,0,0,0,0,0,1,1
strain,0,0,0,0,0,1,1
twinkies,0,0,0,0,0,1,1
little rock,0,0,0,0,0,1,1
tallahassee,0,0,0,0,0,1,1
pacific playland,0,0,0,0,0,1,1
twinkie,0,0,0,0,0,1,1
stathis,0,0,0,0,0,1,1
brundlefly,0,0,0,0,0,1,1
bartok science industries,0,0,0,0,0,1,1
characteristic,0,0,0,0,0,1,1
unfold,1,0,0,0,0,0,1
tow,0,0,0,0,0,1,1
middle east,0,0,0,0,0,1,1
getley,0,0,0,0,0,1,1
bobby,0,0,0,0,0,1,1
crusader,0,0,0,0,0,1,1
harpy,0,0,0,0,0,1,1
receiving,0,0,0,0,0,1,1
funding,0,0,0,0,0,1,1
bartok,0,0,0,0,0,1,1
teleporting,0,0,0,0,0,1,1
brundle,0,0,0,0,0,1,1
brundlefly-telepod,0,0,0,0,0,1,1
potency,0,0,0,0,0,1,1
vomit,0,0,0,0,0,1,1
housefly,0,0,0,0,0,1,1
leroux,0,0,0,0,0,1,1
recess,0,0,0,0,0,1,1
opéra,0,0,0,0,0,1,1
the violet death,0,0,0,0,0,1,1
industrial,0,0,0,0,0,1,1
ghosts,0,0,0,0,0,1,1
central industrial prison,0,0,0,0,0,1,1
lockdown,0,0,0,0,0,1,1
windy,0,0,0,0,0,1,1
tao,0,0,0,0,0,1,1
sian,0,0,0,0,0,1,1
stalemate,0,0,0,0,0,1,1
centipede,0,0,0,0,0,1,1
daybreak,0,0,0,0,0,1,1
villa,0,0,0,0,0,1,1
chant,0,0,0,0,0,1,1
chu,0,0,0,0,0,1,1
autumn,0,0,0,0,0,1,1
sub inspector damu,0,0,0,0,0,1,1
aby,0,0,0,0,0,1,1
damu,0,0,0,0,0,1,1
eruption,0,0,0,0,0,1,1
esmeralda,0,0,0,0,0,1,1
duc,0,0,0,0,0,1,1
deliverance,0,0,0,0,0,1,1
gloria,0,0,0,0,0,1,1
hop-toad,0,0,0,0,0,1,1
slope,0,0,0,0,0,1,1
hop,0,0,0,0,0,1,1
sic,0,0,0,0,0,1,1
dominion,0,0,0,0,0,1,1
prospero's,0,0,0,0,0,1,1
liberation,0,0,0,0,0,1,1
the blue death,0,0,0,0,0,1,1
tarot,0,0,0,0,0,1,1
macabre,0,0,0,0,0,1,1
"the ""white death""",0,0,0,0,0,1,1
satanist,0,0,0,0,0,1,1
goblet,0,0,0,0,0,1,1
satanic,0,0,0,0,0,1,1
juliana,0,0,0,0,0,1,1
etiquette,0,0,0,0,0,1,1
sandersons,0,0,0,0,0,1,1
binx,0,0,0,0,0,1,1
hallows,0,0,0,0,0,1,1
treater,0,0,0,0,0,1,1
wolfman,0,0,0,0,0,1,1
stoop,0,0,0,0,0,1,1
helper,0,0,0,0,0,1,1
happening,0,0,0,0,0,1,1
improvisation,0,0,0,0,0,1,1
phoebe,0,0,0,0,0,1,1
the frankenstein creature,0,0,0,0,0,1,1
scary german guy,0,0,0,0,0,1,1
clubhouse,0,0,0,0,0,1,1
reach,0,0,0,0,0,1,1
the monster squad,0,0,0,0,0,1,1
grasp,0,0,0,0,0,1,1
instant,0,0,0,0,0,1,1
hint,0,0,0,0,0,1,1
tansy,0,0,0,0,0,1,1
carr,0,0,0,0,0,1,1
limping,0,0,0,0,0,1,1
nandish,0,0,0,0,0,1,1
puttachari,0,0,0,0,0,1,1
tantrik,0,0,0,0,0,1,1
allison,0,0,0,0,0,1,1
dani,0,0,0,0,0,1,1
kiln,0,0,0,0,0,1,1
sanderson,0,0,0,0,0,1,1
emily,0,0,0,0,0,1,1
butcherson,0,0,0,0,0,1,1
dennison,0,0,0,0,0,1,1
sprinkler,0,0,0,0,0,1,1
broom,0,0,0,0,0,1,1
chennabasappa,0,0,0,0,0,1,1
salem,0,0,0,0,0,1,1
spellbook,0,0,0,0,0,1,1
winifred,0,0,0,0,0,1,1
thackery,0,0,0,0,0,1,1
baswa,0,0,0,0,0,1,1
shashtri,0,0,0,0,0,1,1
lemon,0,0,0,0,0,1,1
brandy,0,0,0,0,0,1,1
gino,0,0,0,0,0,1,1
depravity,0,0,0,0,0,1,1
tep,0,0,0,0,0,1,1
iconsofhorrorkarloff3542.htm,0,0,0,0,0,1,1
we,0,0,0,0,0,1,1
tyrolean,0,0,0,0,0,1,1
vitus,0,0,0,0,0,1,1
austrian,0,0,0,0,0,1,1
hjalmar,0,0,0,0,0,1,1
marmorus,0,0,0,0,0,1,1
newlyweds,0,0,0,0,0,1,1
hallucinogen,0,0,0,0,0,1,1
poelzig,0,0,0,0,0,1,1
hungarians,0,0,0,0,0,1,1
hyosine,0,0,0,0,0,1,1
alison,0,0,0,0,0,1,1
rites,0,0,0,0,0,1,1
werdegast,0,0,0,0,0,1,1
dumplings,0,0,0,0,0,1,1
ingredient,0,0,0,0,0,1,1
mashka,0,0,0,0,0,1,1
lussan,0,0,0,0,0,1,1
berghmann,0,0,0,0,0,1,1
negative,0,0,0,0,0,1,1
caleb,0,0,0,0,0,1,1
bookcase,0,0,0,0,0,1,1
escalates,0,0,0,0,0,1,1
tonn,0,0,0,0,0,1,1
bangkok,0,0,0,0,0,1,1
kilogram,0,0,0,0,0,1,1
natre,0,0,0,0,0,1,1
tun,0,0,0,0,0,1,1
thea,0,0,0,0,0,1,1
verdi,0,0,0,0,0,1,1
betty,0,0,0,0,0,1,1
macbeth,0,0,0,0,0,1,1
hassell,0,0,0,0,0,1,1
gregor,0,0,0,0,0,1,1
mastiff,0,0,0,0,0,1,1
in.com,0,0,0,0,0,1,1
pecker,0,0,0,0,0,1,1
impersonator,0,0,0,0,0,1,1
prince prospero,0,0,0,0,0,1,1
frailty,0,0,0,0,0,1,1
galeen,0,0,0,0,0,1,1
rosary,0,0,0,0,0,1,1
bram,0,0,0,0,0,1,1
flaw,0,0,0,0,0,1,1
greta,0,0,0,0,0,1,1
the north sea,0,0,0,0,0,1,1
crucifix,0,0,0,0,0,1,1
cinematographer,0,0,0,0,0,1,1
frederich,0,0,0,0,0,1,1
stoker,0,0,0,0,0,1,1
murnau,0,0,0,0,0,1,1
scriptwriter,0,0,0,0,0,1,1
generator,0,0,0,0,0,1,1
wolfgang,0,0,0,0,0,1,1
slovak,0,0,0,0,0,1,1
francesca,0,0,0,0,0,1,1
prospero,0,0,0,0,0,1,1
schreck,0,0,0,0,0,1,1
rescuer,0,0,0,0,0,1,1
ferret,0,0,0,0,0,1,1
haff,0,0,0,0,0,1,1
resting,0,0,0,0,0,1,1
gash,0,0,0,0,0,1,1
slow,0,0,0,0,0,1,1
east texas,0,0,0,0,0,1,1
propane,0,0,0,0,0,1,1
shady,0,0,0,0,0,1,1
documentation,0,0,0,0,0,1,1
ho,0,0,0,0,0,1,1
wangenheim,0,0,0,0,0,1,1
zapruder,0,0,0,0,0,1,1
campfire,0,0,0,0,0,1,1
henrik,0,0,0,0,0,1,1
arno,0,0,0,0,0,1,1
mutter,0,0,0,0,0,1,1
grau,0,0,0,0,0,1,1
albin,0,0,0,0,0,1,1
eaton,0,0,0,0,0,1,1
salisbury plain,0,0,0,0,0,1,1
paris opera house,0,0,0,0,0,1,1
insincerity,0,0,0,0,0,1,1
slideshow,0,0,0,0,0,1,1
brigitte,0,0,0,0,0,1,1
ginger,0,0,0,0,0,1,1
breathing,0,0,0,0,0,1,1
lycanthrope,0,0,0,0,0,1,1
navel,0,0,0,0,0,1,1
downs,0,0,0,0,0,1,1
greenhouse bash,0,0,0,0,0,1,1
pa,0,0,0,0,0,1,1
monkshood,0,0,0,0,0,1,1
ginger-wolf,0,0,0,0,0,1,1
greenhouse,0,0,0,0,0,1,1
freezer,0,0,0,0,0,1,1
bash,0,0,0,0,0,1,1
edmund,0,0,0,0,0,1,1
thatchers,0,0,0,0,0,1,1
thatcher,0,0,0,0,0,1,1
trina,0,0,0,0,0,1,1
pretence,0,0,0,0,0,1,1
richelieu,0,0,0,0,0,1,1
the greenhouse bash,0,0,0,0,0,1,1
bodybuilding,0,0,0,0,0,1,1
revenant,0,0,0,0,0,1,1
spec,0,0,0,0,0,1,1
verrill,0,0,0,0,0,1,1
segue,0,0,0,0,0,1,1
forecast,0,0,0,0,0,1,1
seaweed,0,0,0,0,0,1,1
yeti,0,0,0,0,0,1,1
bedelia,0,0,0,0,0,1,1
dexter,0,0,0,0,0,1,1
jocularity,0,0,0,0,0,1,1
bitner,0,0,0,0,0,1,1
coopers,0,0,0,0,0,1,1
larson,0,0,0,0,0,1,1
the house of zombies,0,0,0,0,0,1,1
redneck,0,0,0,0,0,1,1
vigilante,0,0,0,0,0,1,1
vollin,0,0,0,0,0,1,1
bateman,0,0,0,0,0,1,1
beau,0,0,0,0,0,1,1
theology,0,0,0,0,0,1,1
o'clock,0,0,0,0,0,1,1
purity,0,0,0,0,0,1,1
culpability,0,0,0,0,0,1,1
ogre,0,0,0,0,0,1,1
ensai,0,0,0,0,0,1,1
vampyre,0,0,0,0,0,1,1
convent,0,0,0,0,0,1,1
bloofer,0,0,0,0,0,1,1
garlic,0,0,0,0,0,1,1
the brides of dracula,0,0,0,0,0,1,1
decapitation,0,0,0,0,0,1,1
caliber,0,0,0,0,0,1,1
hearse,0,0,0,0,0,1,1
pritchard,0,0,0,0,0,1,1
trent,0,0,0,0,0,1,1
splash,0,0,0,0,0,1,1
loren,0,0,0,0,0,1,1
enma,0,0,0,0,0,1,1
lotus,0,0,0,0,0,1,1
shirō,0,0,0,0,0,1,1
harumi,0,0,0,0,0,1,1
yukiko,0,0,0,0,0,1,1
realms,0,0,0,0,0,1,1
hallucinates,0,0,0,0,0,1,1
kyōichi,0,0,0,0,0,1,1
rancid,0,0,0,0,0,1,1
hariya,0,0,0,0,0,1,1
vortex,0,0,0,0,0,1,1
the eight realms of hell by lord enma,0,0,0,0,0,1,1
kasuma,0,0,0,0,0,1,1
yajima,0,0,0,0,0,1,1
yakuza,0,0,0,0,0,1,1
akagawa,0,0,0,0,0,1,1
gōzō,0,0,0,0,0,1,1
diagnosis,0,0,0,0,0,1,1
sachiko,0,0,0,0,0,1,1
tamura,0,0,0,0,0,1,1
atlas,0,0,0,0,0,1,1
seawater,0,0,0,0,0,1,1
itching,0,0,0,0,0,1,1
together,0,0,0,0,0,1,1
gizi,0,0,0,0,0,1,1
visage,0,0,0,0,0,1,1
aczél,0,0,0,0,0,1,1
girth,0,0,0,0,0,1,1
preservative,0,0,0,0,0,1,1
butter,0,0,0,0,0,1,1
morosgoványi,0,0,0,0,0,1,1
öreg,0,0,0,0,0,1,1
taxidermist,0,0,0,0,0,1,1
hungarian,0,0,0,0,0,1,1
vendel,0,0,0,0,0,1,1
jenő,0,0,0,0,0,1,1
balatony,0,0,0,0,0,1,1
lockjaw,0,0,0,0,0,1,1
savaard,0,0,0,0,0,1,1
margaret,0,0,0,0,0,1,1
orangutan,0,0,0,0,0,1,1
kálmán,0,0,0,0,0,1,1
lajoska,0,0,0,0,0,1,1
eating,0,0,0,0,0,1,1
mocata,0,0,0,0,0,1,1
recitation,0,0,0,0,0,1,1
aron,0,0,0,0,0,1,1
hecate,0,0,0,0,0,1,1
conjuring,0,0,0,0,0,1,1
the duc de richelieu,0,0,0,0,0,1,1
marking,0,0,0,0,0,1,1
pentagram,0,0,0,0,0,1,1
rijn,0,0,0,0,0,1,1
painkiller,0,0,0,0,0,1,1
tanith,0,0,0,0,0,1,1
eatons,0,0,0,0,0,1,1
ioc,0,0,0,0,0,1,1
latrine,0,0,0,0,0,1,1
eater,0,0,0,0,0,1,1
decades,0,0,0,0,0,1,1
sodomy,0,0,0,0,0,1,1
carlsbruck,0,0,0,0,0,1,1
councillor,0,0,0,0,0,1,1
wilma,0,0,0,0,0,1,1
kleve,0,0,0,0,0,1,1
substance,0,0,0,0,0,1,1
bathwater,0,0,0,0,0,1,1
becky,0,0,0,0,0,1,1
idle,0,0,0,0,0,1,1
creature(the,0,0,0,0,0,1,1
wentworth,0,0,0,0,0,1,1
fluffy,0,0,0,0,0,1,1
gereson,0,0,0,0,0,1,1
grantham,0,0,0,0,0,1,1
murderousness,0,0,0,0,0,1,1
lament,0,0,0,0,0,1,1
stan,0,0,0,0,0,1,1
northrup,0,0,0,0,0,1,1
meteorite,0,0,0,0,0,1,1
cockroach,0,0,0,0,0,1,1
mysophobia,0,0,0,0,0,1,1
creep,0,0,0,0,0,1,1
escaping,0,0,0,0,0,1,1
ashtray,0,0,0,0,0,1,1
crap,0,0,0,0,0,1,1
roach,0,0,0,0,0,1,1
chimpanzee,0,0,0,0,0,1,1
aswangs,0,0,0,0,0,1,1
aswang,0,0,0,0,0,1,1
elisa,0,0,0,0,0,1,1
spry,0,0,0,0,0,1,1
weeds,0,0,0,0,0,1,1
upson,0,0,0,0,0,1,1
layer,0,0,0,0,0,1,1
jordy,0,0,0,0,0,1,1
creepshow,0,0,0,0,0,1,1
cass,0,0,0,0,0,1,1
pratt,0,0,0,0,0,1,1
vickers,0,0,0,0,0,1,1
pastry,0,0,0,0,0,1,1
custodian,0,0,0,0,0,1,1
headstone,0,0,0,0,0,1,1
caleb colton,0,0,0,0,0,1,1
mae,0,0,0,0,0,1,1
colton,0,0,0,0,0,1,1
buffalora,0,0,0,0,0,1,1
gna,0,0,0,0,0,1,1
sulphur,0,0,0,0,0,1,1
henrich,0,0,0,0,0,1,1
krogh,0,0,0,0,0,1,1
ygor,0,0,0,0,0,1,1
graverobbing,0,0,0,0,0,1,1
joyce,0,0,0,0,0,1,1
cranny,0,0,0,0,0,1,1
wilder,0,0,0,0,0,1,1
wally,0,0,0,0,0,1,1
beal,0,0,0,0,0,1,1
gong,0,0,0,0,0,1,1
executor,0,0,0,0,0,1,1
crosby,0,0,0,0,0,1,1
lu,0,0,0,0,0,1,1
campbell,0,0,0,0,0,1,1
patterson,0,0,0,0,0,1,1
gnaghi,0,0,0,0,0,1,1
dashboard,0,0,0,0,0,1,1
proofing,0,0,0,0,0,1,1
returners,0,0,0,0,0,1,1
heater,0,0,0,0,0,1,1
leering,0,0,0,0,0,1,1
buffalora cemetery,0,0,0,0,0,1,1
francesco and gnaghi,0,0,0,0,0,1,1
francesco,0,0,0,0,0,1,1
fixation,0,0,0,0,0,1,1
campaigning,0,0,0,0,0,1,1
sisyphean,0,0,0,0,0,1,1
valentina,0,0,0,0,0,1,1
iodine,0,0,0,0,0,1,1
internment,0,0,0,0,0,1,1
slam,0,0,0,0,0,1,1
falchi,0,0,0,0,0,1,1
he,0,0,0,0,0,1,1
planting,0,0,0,0,0,1,1
franco,0,0,0,0,0,1,1
resvrrectvris,0,0,0,0,0,1,1
myers,0,0,0,0,0,1,1
everglades,0,0,0,0,0,1,1
rhodes,0,0,0,0,0,1,1
fisher,0,0,0,0,0,1,1
phibes,0,0,0,0,0,1,1
frogs,0,0,0,0,0,1,1
rats,0,0,0,0,0,1,1
testament,0,0,0,0,0,1,1
bee,0,0,0,0,0,1,1
bats,0,0,0,0,0,1,1
unicorn,0,0,0,0,0,1,1
locusts,0,0,0,0,0,1,1
hail,0,0,0,0,0,1,1
longstreet,0,0,0,0,0,1,1
hedgepath,0,0,0,0,0,1,1
lid,0,0,0,0,0,1,1
the old testament,0,0,0,0,0,1,1
lem,0,0,0,0,0,1,1
trout,0,0,0,0,0,1,1
locust,0,0,0,0,0,1,1
the ten plagues,0,0,0,0,0,1,1
boils,0,0,0,0,0,1,1
hargreaves,0,0,0,0,0,1,1
kitaj,0,0,0,0,0,1,1
chapel,0,0,0,0,0,1,1
enclave,0,0,0,0,0,1,1
mcdermott,0,0,0,0,0,1,1
fort myers,0,0,0,0,0,1,1
bub,0,0,0,0,0,1,1
survivors,0,0,0,0,0,1,1
novelist,0,0,0,0,0,1,1
byrne,0,0,0,0,0,1,1
barbiturate,0,0,0,0,0,1,1
perry,0,0,0,0,0,1,1
ghostbusting,0,0,0,0,0,1,1
manson,0,0,0,0,0,1,1
lynskey,0,0,0,0,0,1,1
madga,0,0,0,0,0,1,1
dammers,0,0,0,0,0,1,1
grim,0,0,0,0,0,1,1
bannister,0,0,0,0,0,1,1
returner,0,0,0,0,0,1,1
dellamorte,0,0,0,0,0,1,1
thrower,0,0,0,0,0,1,1
hounds,0,0,0,0,0,1,1
"doc , babe ,",0,0,0,0,0,1,1
bumbu,0,0,0,0,0,1,1
maizie,0,0,0,0,0,1,1
phroso,0,0,0,0,0,1,1
tiny,0,0,0,0,0,1,1
zanzibar,0,0,0,0,0,1,1
babe,0,0,0,0,0,1,1
"doc,",0,0,0,0,0,1,1
laddie,0,0,0,0,0,1,1
frenzy,0,0,0,0,0,1,1
boardwalk,0,0,0,0,0,1,1
emerson,0,0,0,0,0,1,1
antler,0,0,0,0,0,1,1
grandpa,0,0,0,0,0,1,1
powerless,0,0,0,0,0,1,1
staking,0,0,0,0,0,1,1
objective,0,0,0,0,0,1,1
maisie,0,0,0,0,0,1,1
railing,0,0,0,0,0,1,1
evelyn,0,0,0,0,0,1,1
the opéra populaire,0,0,0,0,0,1,1
populaire,0,0,0,0,0,1,1
ribbon,0,0,0,0,0,1,1
imprisons,0,0,0,0,0,1,1
viscount,0,0,0,0,0,1,1
piangi,0,0,0,0,0,1,1
soprano,0,0,0,0,0,1,1
auctioneer,0,0,0,0,0,1,1
protégé,0,0,0,0,0,1,1
mp-40,0,0,0,0,0,1,1
giry,0,0,0,0,0,1,1
velvet,0,0,0,0,0,1,1
meg,0,0,0,0,0,1,1
candelabrum,0,0,0,0,0,1,1
daaé,0,0,0,0,0,1,1
mondo,0,0,0,0,0,1,1
motorboat,0,0,0,0,0,1,1
santa carla,0,0,0,0,0,1,1
fridge,0,0,0,0,0,1,1
rollo the knife,0,0,0,0,0,1,1
nanook,0,0,0,0,0,1,1
hawkes,0,0,0,0,0,1,1
solo,0,0,0,0,0,1,1
geckos,0,0,0,0,0,1,1
pandemónium,0,0,0,0,0,1,1
stripper,0,0,0,0,0,1,1
disco,0,0,0,0,0,1,1
frost,0,0,0,0,0,1,1
biker,0,0,0,0,0,1,1
rollo,0,0,0,0,0,1,1
gogol,0,0,0,0,0,1,1
galatea,0,0,0,0,0,1,1
frances,0,0,0,0,0,1,1
orlacs,0,0,0,0,0,1,1
orlac,0,0,0,0,0,1,1
fontainebleau,0,0,0,0,0,1,1
drake,0,0,0,0,0,1,1
horreurs,0,0,0,0,0,1,1
richie,0,0,0,0,0,1,1
titty,0,0,0,0,0,1,1
mcgraw,0,0,0,0,0,1,1
rey,0,0,0,0,0,1,1
surf nazis,0,0,0,0,0,1,1
the head vampire,0,0,0,0,0,1,1
underside,0,0,0,0,0,1,1
gecko,0,0,0,0,0,1,1
pussy,0,0,0,0,0,1,1
chet,0,0,0,0,0,1,1
rv,0,0,0,0,0,1,1
jacob,0,0,0,0,0,1,1
safehouse,0,0,0,0,0,1,1
sex machine,0,0,0,0,0,1,1
"the ""titty twister"" bar",0,0,0,0,0,1,1
fullers,0,0,0,0,0,1,1
el rey,0,0,0,0,0,1,1
"the ""titty twister""",0,0,0,0,0,1,1
pastor,0,0,0,0,0,1,1
santánico,0,0,0,0,0,1,1
vulnavia,0,0,0,0,0,1,1
whitcombe,0,0,0,0,0,1,1
scotland yard,0,0,0,0,0,1,1
downe,0,0,0,0,0,1,1
mammon,0,0,0,0,0,1,1
l.a.p.d.,0,0,0,0,0,1,1
condo,0,0,0,0,0,1,1
hennessy,0,0,0,0,0,1,1
gabriel,0,0,0,0,0,1,1
favoritism,0,0,0,0,0,1,1
chas,0,0,0,0,0,1,1
christ,0,0,0,0,0,1,1
members,0,0,0,0,0,1,1
abattoir,0,0,0,0,0,1,1
arms.{{cite,0,0,0,0,0,1,1
transcendental,0,0,0,0,0,1,1
mademoiselle,0,0,0,0,0,1,1
transcendence,0,0,0,0,0,1,1
intertitle,0,0,0,0,0,1,1
sundown,0,0,0,0,0,1,1
arise,0,0,0,0,0,1,1
constantine,0,0,0,0,0,1,1
beeman,0,0,0,0,0,1,1
dodson,0,0,0,0,0,1,1
repentance,0,0,0,0,0,1,1
königsberg,0,0,0,0,0,1,1
foppish,0,0,0,0,0,1,1
krolock,0,0,0,0,0,1,1
eastern european,0,0,0,0,0,1,1
yoine,0,0,0,0,0,1,1
interrogates,0,0,0,0,0,1,1
balthazar,0,0,0,0,0,1,1
papa,0,0,0,0,0,1,1
lung,0,0,0,0,0,1,1
sigils,0,0,0,0,0,1,1
consultation,0,0,0,0,0,1,1
isabel,0,0,0,0,0,1,1
nicotine,0,0,0,0,0,1,1
midnite,0,0,0,0,0,1,1
reawakens,0,0,0,0,0,1,1
"beeman , hennessy",0,0,0,0,0,1,1
companionship,0,0,0,0,0,1,1
hopkins,0,0,0,0,0,1,1
abronsius,0,0,0,0,0,1,1
unconscious,0,0,0,0,0,1,1
nylon,0,0,0,0,0,1,1
parisian,0,0,0,0,0,1,1
giorgio,0,0,0,0,0,1,1
rosy,0,0,0,0,0,1,1
seconds,0,0,0,0,0,1,1
buzzing,0,0,0,0,0,1,1
regularity,0,0,0,0,0,1,1
sapphire,0,0,0,0,0,1,1
stocking,0,0,0,0,0,1,1
precaution,0,0,0,0,0,1,1
odor,0,0,0,0,0,1,1
wurdalak,0,0,0,0,0,1,1
east end,0,0,0,0,0,1,1
souvenir,0,0,0,0,0,1,1
vladimir,0,0,0,0,0,1,1
severen,0,0,0,0,0,1,1
diamondback,0,0,0,0,0,1,1
sdenka,0,0,0,0,0,1,1
tranquilizer,0,0,0,0,0,1,1
pietro,0,0,0,0,0,1,1
alvin,0,0,0,0,0,1,1
the town hall,0,0,0,0,0,1,1
prenderghast,0,0,0,0,0,1,1
blithe,0,0,0,0,0,1,1
mitch,0,0,0,0,0,1,1
citizenry,0,0,0,0,0,1,1
blithe hollow,0,0,0,0,0,1,1
grievance,0,0,0,0,0,1,1
salma,0,0,0,0,0,1,1
durfe,0,0,0,0,0,1,1
babcock,0,0,0,0,0,1,1
consideration,0,0,0,0,0,1,1
aggie,0,0,0,0,0,1,1
courtney,0,0,0,0,0,1,1
the town hall's,0,0,0,0,0,1,1
intrudes,0,0,0,0,0,1,1
gorcha,0,0,0,0,0,1,1
koukol,0,0,0,0,0,1,1
fondness,0,0,0,0,0,1,1
vesalius,0,0,0,0,0,1,1
houmfort,0,0,0,0,0,1,1
gravel,0,0,0,0,0,1,1
mchenry,0,0,0,0,0,1,1
bosley,0,0,0,0,0,1,1
muffy,0,0,0,0,0,1,1
anus,0,0,0,0,0,1,1
isis,0,0,0,0,0,1,1
grosvenor,0,0,0,0,0,1,1
ralph,0,0,0,0,0,1,1
ankh,0,0,0,0,0,1,1
the scroll of thoth,0,0,0,0,0,1,1
the cairo museum,0,0,0,0,0,1,1
thoth,0,0,0,0,0,1,1
ardath,0,0,0,0,0,1,1
whemple,0,0,0,0,0,1,1
imhotep,0,0,0,0,0,1,1
princess ankh-es-en-amon,0,0,0,0,0,1,1
saint sebastian,0,0,0,0,0,1,1
nudist,0,0,0,0,0,1,1
coo-coo,0,0,0,0,0,1,1
lam,0,0,0,0,0,1,1
cthulhu,0,0,0,0,0,1,1
allen,0,0,0,0,0,1,1
dunwoody,0,0,0,0,0,1,1
beasts,0,0,0,0,0,1,1
embalming,0,0,0,0,0,1,1
sarcophagus,0,0,0,0,0,1,1
plagues,0,0,0,0,0,1,1
adheres,0,0,0,0,0,1,1
lovecraft,0,0,0,0,0,1,1
spit,0,0,0,0,0,1,1
legrasse,0,0,0,0,0,1,1
emma,0,0,0,0,0,1,1
rabies,0,0,0,0,0,1,1
coo,0,0,0,0,0,1,1
mortville,0,0,0,0,0,1,1
deviant,0,0,0,0,0,1,1
grizelda,0,0,0,0,0,1,1
effigy,0,0,0,0,0,1,1
willpower,0,0,0,0,0,1,1
magda,0,0,0,0,0,1,1
saber,0,0,0,0,0,1,1
scavenging,0,0,0,0,0,1,1
charnel,0,0,0,0,0,1,1
krempe,0,0,0,0,0,1,1
accumulation,0,0,0,0,0,1,1
raving,0,0,0,0,0,1,1
gaoler,0,0,0,0,0,1,1
urquhart,0,0,0,0,0,1,1
straircase,0,0,0,0,0,1,1
aging,0,0,0,0,0,1,1
succeeding,0,0,0,0,0,1,1
charnel house,0,0,0,0,0,1,1
shagal,0,0,0,0,0,1,1
stairway,0,0,0,0,0,1,1
wintry,0,0,0,0,0,1,1
the university of königsberg,0,0,0,0,0,1,1
angst,0,0,0,0,0,1,1
maidservant,0,0,0,0,0,1,1
rohman,0,0,0,0,0,1,1
doris,0,0,0,0,0,1,1
greco,0,0,0,0,0,1,1
housemaid,0,0,0,0,0,1,1
betsy,0,0,0,0,0,1,1
ellison,0,0,0,0,0,1,1
ti,0,0,0,0,0,1,1
lancelot,0,0,0,0,0,1,1
holland,0,0,0,0,0,1,1
calypso,0,0,0,0,0,1,1
sabreur,0,0,0,0,0,1,1
euthanasia,0,0,0,0,0,1,1
horseman,0,0,0,0,0,1,1
wesley,0,0,0,0,0,1,1
hollands,0,0,0,0,0,1,1
carre,0,0,0,0,0,1,1
connell,0,0,0,0,0,1,1
lamica,0,0,0,0,0,1,1
lang,0,0,0,0,0,1,1
ginsei,0,0,0,0,0,1,1
african-americans,0,0,0,0,0,1,1
maze,0,0,0,0,0,1,1
cleef,0,0,0,0,1,0,1
mutsuta,0,0,0,0,1,0,1
sanjuro,0,0,0,0,1,0,1
camellia,0,0,0,0,1,0,1
musuta,0,0,0,0,1,0,1
hanbei,0,0,0,0,1,0,1
muroto,0,0,0,0,1,0,1
chamberlain,0,0,0,0,1,0,1
fiasco,0,0,0,0,1,0,1
civility,0,0,0,0,1,0,1
cheery,0,0,0,0,1,0,1
sanjūrō,0,0,0,0,1,0,1
parchment,0,0,0,0,1,0,1
kinkaid,0,0,0,0,1,0,1
heed,0,0,0,0,1,0,1
bridger's pass,0,0,0,0,1,0,1
grier,0,0,0,0,1,0,1
preacher,0,0,0,0,1,0,1
tetley,0,0,0,0,1,0,1
petition,0,0,0,0,1,0,1
tsubaki,0,0,0,0,1,0,1
mmg,0,0,0,0,1,0,1
insensitivity,0,0,0,0,1,0,1
shunning,0,0,0,0,1,0,1
suction,0,0,0,0,1,0,1
superpower,0,0,0,0,1,0,1
babysitter,0,0,0,0,1,0,1
parrs,0,0,0,0,1,0,1
foe,0,0,0,0,1,0,1
omnidroid,0,0,0,0,1,0,1
parr,0,0,0,0,1,0,1
reminisces,0,0,0,0,1,0,1
supers,0,0,0,0,1,0,1
relocation,0,0,0,0,1,0,1
incredible,0,0,0,0,1,0,1
metroville,0,0,0,0,1,0,1
incrediboy,0,0,0,0,1,0,1
incarnation,0,0,0,0,1,0,1
accessory,0,0,0,0,1,0,1
best,0,0,0,0,1,0,1
gerald,0,0,0,0,1,0,1
morez,0,0,0,0,1,0,1
farnley,0,0,0,0,1,0,1
ox,0,0,0,0,1,0,1
alva,0,0,0,0,1,0,1
bridger,0,0,0,0,1,0,1
davies,0,0,0,0,1,0,1
hyderabad,0,0,0,0,1,0,1
andhra,0,0,0,0,1,0,1
kurnool,0,0,0,0,1,0,1
charminar,0,0,0,0,1,0,1
ajay and swapna,0,0,0,0,1,0,1
aasha,0,0,0,0,1,0,1
rami,0,0,0,0,1,0,1
pradesh,0,0,0,0,1,0,1
obul,0,0,0,0,1,0,1
geetha,0,0,0,0,1,0,1
tagore,0,0,0,0,1,0,1
revelry,0,0,0,0,1,0,1
balbir,0,0,0,0,1,0,1
badrinaryana,0,0,0,0,1,0,1
pike's corner,0,0,0,0,1,0,1
darby,0,0,0,0,1,0,1
davenport,0,0,0,0,1,0,1
bridger's wells,0,0,0,0,1,0,1
rustling,0,0,0,0,1,0,1
gil,0,0,0,0,1,0,1
croft,0,0,0,0,1,0,1
lynching,0,0,0,0,1,0,1
swanson,0,0,0,0,1,0,1
sparks,0,0,0,0,1,0,1
deputization,0,0,0,0,1,0,1
stephens,1,0,0,0,0,0,1
privacy,0,0,0,0,1,0,1
hardwicke,0,0,0,0,1,0,1
rustler,0,0,0,0,1,0,1
mapen,0,0,0,0,1,0,1
conroy,0,0,0,0,1,0,1
risley,0,0,0,0,1,0,1
vicinity,0,0,0,0,1,0,1
stickup,0,0,0,0,1,0,1
edna,0,0,0,0,1,0,1
gazerbeam,0,0,0,0,1,0,1
"super, gazerbeam",0,0,0,0,1,0,1
coal,0,0,0,0,1,0,1
skimmer,0,0,0,0,1,0,1
aya,0,0,0,0,1,0,1
sasori,0,0,0,0,1,0,1
koike,0,0,0,0,1,0,1
pervert,0,0,0,0,1,0,1
honda,0,0,0,0,1,0,1
tetsu,0,0,0,0,1,0,1
panty,0,0,0,0,1,0,1
yu,0,0,0,0,1,0,1
the zero church,0,0,0,0,1,0,1
chun,0,0,0,0,1,0,1
foshan,0,0,0,0,1,0,1
ip,0,0,0,0,1,0,1
mastery,0,0,0,0,1,0,1
shanzhao,0,0,0,0,1,0,1
dummy,0,0,0,0,1,0,1
ching,0,0,0,0,1,0,1
etta,0,0,0,0,1,0,1
the union pacific overland flyer,0,0,0,0,1,0,1
sundance,0,0,0,0,1,0,1
garris,0,0,0,0,1,0,1
http://www.cswap.com/1982/burden_of_dreams/cap/en/25fps/a/01_11,0,0,0,0,1,0,1
mule,0,0,0,0,1,0,1
lefors,0,0,0,0,1,0,1
envisions,0,0,0,0,1,0,1
overland,0,0,0,0,1,0,1
cassidy,0,0,0,0,1,0,1
union pacific,0,0,0,0,1,0,1
bolivia,0,0,0,0,1,0,1
bandidos,0,0,0,0,1,0,1
harriman,0,0,0,0,1,0,1
bolivian,0,0,0,0,1,0,1
yanquis,0,0,0,0,1,0,1
bledsoe,0,0,0,0,1,0,1
scramble,0,0,0,0,1,0,1
los bandidos yanquis,0,0,0,0,1,0,1
1890s,0,0,0,0,1,0,1
barrage,0,0,0,0,1,0,1
wooden,0,0,0,0,1,0,1
"supers""—humans",0,0,0,0,1,0,1
karate,0,0,0,0,1,0,1
ndebele,0,0,0,0,1,0,1
the shangani patrol,0,0,0,0,1,0,1
sepia,0,0,0,0,1,0,1
leander,0,0,0,0,1,0,1
southern rhodesia,0,0,0,0,1,0,1
forbes,0,0,0,0,1,0,1
rhodesia,0,0,0,0,1,0,1
mashonaland,0,0,0,0,1,0,1
deserter,0,0,0,0,1,0,1
rhodesians,0,0,0,0,1,0,1
fort salisbury,0,0,0,0,1,0,1
steed,0,0,0,0,1,0,1
"locale, mashonaland",0,0,0,0,1,0,1
matopo,0,0,0,0,1,0,1
underminer,0,0,0,0,1,0,1
midway,0,0,0,0,1,0,1
intervening,0,0,0,0,1,0,1
induna,0,0,0,0,1,0,1
stuart brown,0,0,0,0,1,0,1
the shangani river,0,0,0,0,1,0,1
miura,0,0,0,0,1,0,1
cooly,0,0,0,0,1,0,1
sato,0,0,0,0,1,0,1
stylist,0,0,0,0,1,0,1
southern chinese,0,0,0,0,1,0,1
chuen,0,0,0,0,1,0,1
northern chinese,0,0,0,0,1,0,1
karateka,0,0,0,0,1,0,1
jameson,0,0,0,0,1,0,1
locale,0,0,0,0,1,0,1
bsac,0,0,0,0,1,0,1
lobengula,0,0,0,0,1,0,1
shangani,0,0,0,0,1,0,1
matabele,0,0,0,0,1,0,1
awol,0,0,0,0,1,0,1
shona,0,0,0,0,1,0,1
hills,0,0,0,0,1,0,1
ghulam,0,0,0,0,1,0,1
das,0,0,0,0,1,0,1
paramour,0,0,0,0,1,0,1
trumpeter,0,0,0,0,1,0,1
the cook county assessor,0,0,0,0,1,0,1
ray's music exchange,0,0,0,0,1,0,1
maître,0,0,0,0,1,0,1
daley,0,0,0,0,1,0,1
marini,0,0,0,0,1,0,1
assessor,0,0,0,0,1,0,1
jailhouse,0,0,0,0,1,0,1
maxwell street,0,0,0,0,1,0,1
trombonist,0,0,0,0,1,0,1
goer,0,0,0,0,1,0,1
bluesmobile,0,0,0,0,1,0,1
blues,0,0,0,0,1,0,1
chez paul,0,0,0,0,1,0,1
murphy,0,0,0,0,1,0,1
gig,0,0,0,0,1,0,1
the illinois nazis,0,0,0,0,1,0,1
bazooka,0,0,0,0,1,0,1
illinois state police,0,0,0,0,1,0,1
them&mdash;a,0,0,0,0,1,0,1
airforce,0,0,0,0,1,0,1
elwood,0,0,0,0,1,0,1
engstrom,0,0,0,0,1,0,1
lyle,0,0,0,0,1,0,1
mapache,0,0,0,0,1,0,1
verde,0,0,0,0,1,0,1
murdoch,0,0,0,0,1,0,1
10&nbsp;miles,0,0,0,0,1,0,1
funnel,0,0,0,0,1,0,1
waterline,0,0,0,0,1,0,1
joughin,0,0,0,0,1,0,1
lightoller,0,0,0,0,1,0,1
rostron,0,0,0,0,1,0,1
collapsibles,0,0,0,0,1,0,1
builder,0,0,0,0,1,0,1
starboard,0,0,0,0,1,0,1
fabulous,0,0,0,0,1,0,1
tossing,0,0,0,0,1,0,1
dixie,0,0,0,0,1,0,1
tab,0,0,0,0,1,0,1
holiday inn,0,0,0,0,1,0,1
illinois national guardsmen,0,0,0,0,1,0,1
blues brothers,0,0,0,0,1,0,1
the battle of the kasserine pass,0,0,0,0,1,0,1
southeast,0,0,0,0,1,0,1
rommel,0,0,0,0,1,0,1
slight,0,0,0,0,1,0,1
jodl,0,0,0,0,1,0,1
rebuilding,0,0,0,0,1,0,1
messina,0,0,0,0,1,0,1
palermo,0,0,0,0,1,0,1
bulge,0,0,0,0,1,0,1
patton,0,0,0,0,1,0,1
jensen,0,0,0,0,1,0,1
northeast,0,0,0,0,1,0,1
erwin,0,0,0,0,1,0,1
kasserine,0,0,0,0,1,0,1
aggression,0,0,0,0,1,0,1
truscott,0,0,0,0,1,0,1
first united states army group,0,0,0,0,1,0,1
northwest,0,0,0,0,1,0,1
the battle of el guettar,0,0,0,0,1,0,1
disquiet,0,0,0,0,1,0,1
conqueror,0,0,0,0,1,0,1
m16,0,0,0,0,1,0,1
lou,0,0,0,0,1,0,1
the military police,0,0,0,0,1,0,1
iou,0,0,0,0,1,0,1
flophouse,0,0,0,0,1,0,1
mount prospect,0,0,0,0,1,0,1
malone,0,0,0,0,1,0,1
seventh,0,0,0,0,1,0,1
codman,0,0,0,0,1,0,1
bastogne,0,0,0,0,1,0,1
the third army,0,0,0,0,1,0,1
detour,0,0,0,0,1,0,1
guettar,0,0,0,0,1,0,1
offhand,0,0,0,0,1,0,1
american ii corps,0,0,0,0,1,0,1
seventh army,0,0,0,0,1,0,1
the mexican federal army,0,0,0,0,1,0,1
m1917,0,0,0,0,1,0,1
deke,0,0,0,0,1,0,1
east pakistan,0,0,0,0,1,0,1
indian air force,0,0,0,0,1,0,1
coy,0,0,0,0,1,0,1
punjab regiment,0,0,0,0,1,0,1
jaisalmer,0,0,0,0,1,0,1
kanwar,0,0,0,0,1,0,1
rcl,0,0,0,0,1,0,1
bhairon singh's,0,0,0,0,1,0,1
bhairon,0,0,0,0,1,0,1
hunter-fighters,0,0,0,0,1,0,1
bhan,0,0,0,0,1,0,1
com,0,0,0,0,1,0,1
mathura,0,0,0,0,1,0,1
subedar,0,0,0,0,1,0,1
kuldip,0,0,0,0,1,0,1
swears,0,0,0,0,1,0,1
airbases,0,0,0,0,1,0,1
bhairon singh,0,0,0,0,1,0,1
bajwa,0,0,0,0,1,0,1
gandhi,0,0,0,0,1,0,1
fighters,0,0,0,0,1,0,1
phool,0,0,0,0,1,0,1
mobilization,0,0,0,0,1,0,1
dastagir,0,0,0,0,1,0,1
bsf,0,0,0,0,1,0,1
chandpuri,0,0,0,0,1,0,1
pakistan air force,0,0,0,0,1,0,1
dharamvir,0,0,0,0,1,0,1
kudip,0,0,0,0,1,0,1
kuldip singh chandpuri,0,0,0,0,1,0,1
kamla,0,0,0,0,1,0,1
jodhpur,0,0,0,0,1,0,1
recce,0,0,0,0,1,0,1
shelling,0,0,0,0,1,0,1
jaiselmer,0,0,0,0,1,0,1
bayonet,0,0,0,0,1,0,1
nco,0,0,0,0,1,0,1
reminisce,0,0,0,0,1,0,1
longewala,0,0,0,0,1,0,1
protagoist,0,0,0,0,1,0,1
yuma,0,0,0,0,1,0,1
ramulamma,0,0,0,0,1,0,1
armament,0,0,0,0,1,0,1
gorch,0,0,0,0,1,0,1
jaime,0,0,0,0,1,0,1
grande,0,0,0,0,1,0,1
timer,0,0,0,0,1,0,1
mohr,0,0,0,0,1,0,1
freddie,0,0,0,0,1,0,1
assignation,0,0,0,0,1,0,1
ammo,0,0,0,0,1,0,1
the mexican revolution,0,0,0,0,1,0,1
bandito,0,0,0,0,1,0,1
freddie sykes,0,0,0,0,1,0,1
the rio grande,0,0,0,0,1,0,1
sykes,0,0,0,0,1,0,1
trestle,0,0,0,0,1,0,1
tector,0,0,0,0,1,0,1
sánchez,0,0,0,0,1,0,1
unprofor,0,0,0,0,1,0,1
bosnian,0,0,0,0,1,0,1
peacekeeper,0,0,0,0,1,0,1
baxter,0,0,0,0,1,0,1
komranna,0,0,0,0,1,0,1
esteban,0,0,0,0,1,0,1
san miguel,0,0,0,0,1,0,1
marisol,0,0,0,0,1,0,1
rojos,0,0,0,0,1,0,1
baxters,0,0,0,0,1,0,1
hacienda,0,0,0,0,1,0,1
ramón,0,0,0,0,1,0,1
cera,0,0,0,0,1,0,1
rojo,0,0,0,0,1,0,1
consuelo,0,0,0,0,1,0,1
chico,0,0,0,0,1,0,1
silvanito,0,0,0,0,1,0,1
the bosnian serbs,0,0,0,0,1,0,1
čiki,0,0,0,0,1,0,1
the united nations protection force,0,0,0,0,1,0,1
fjord,0,0,0,0,1,0,1
tenor,0,0,0,0,1,0,1
grady,0,0,0,0,0,1,1
campana,0,0,0,0,1,0,1
the marine corps,0,0,0,0,1,0,1
ufc,0,0,0,0,1,0,1
jiu,0,0,0,0,1,0,1
desertion,0,0,0,0,1,0,1
brendan,0,0,0,0,1,0,1
conlon,0,0,0,0,1,0,1
the u.s. marine corps,0,0,0,0,1,0,1
iinuma michinojo,0,0,0,0,1,0,1
kayano,0,0,0,0,1,0,1
kodachi,0,0,0,0,1,0,1
grain,0,0,0,0,1,0,1
loser,0,0,0,0,1,0,1
geisha,0,0,0,0,1,0,1
tasogare,0,0,0,0,1,0,1
koda,0,0,0,0,1,0,1
measles,0,0,0,0,1,0,1
commiserates,0,0,0,0,1,0,1
jitsu,0,0,0,0,1,0,1
riordan,0,0,0,0,1,0,1
muthupandi,0,0,0,0,1,0,1
brazilian,0,0,0,0,1,0,1
kickback,1,0,0,0,0,0,1
undertaker,0,0,0,0,1,0,1
rance,0,0,0,0,1,0,1
pompey,0,0,0,0,1,0,1
stoddard,0,0,0,0,1,0,1
easterner,0,0,0,0,1,0,1
appleyard,0,0,0,0,1,0,1
peabody,0,0,0,0,1,0,1
statehood,0,0,0,0,1,0,1
hadley,1,0,0,0,0,0,1
delegate,0,0,0,0,1,0,1
dutton,0,0,0,0,1,0,1
sparta,0,0,0,0,1,0,1
rumours,0,0,0,0,1,0,1
choke,0,0,0,0,1,0,1
hesitation,0,0,0,0,1,0,1
mat,0,0,0,0,1,0,1
zen'emon,0,0,0,0,1,0,1
boshin,0,0,0,0,1,0,1
tomoe,0,0,0,0,1,0,1
rafter,0,0,0,0,1,0,1
tirzah,0,0,0,0,1,0,1
calvary,0,0,0,0,1,0,1
esther,0,0,0,0,1,0,1
arrius,0,0,0,0,1,0,1
hur,0,0,0,0,1,0,1
gratus,0,0,0,0,1,0,1
rower,0,0,0,0,1,0,1
esther haya harareet,0,0,0,0,1,0,1
simonides,0,0,0,0,1,0,1
quadriga,0,0,0,0,1,0,1
macedonian,0,0,0,0,1,0,1
haya,0,0,0,0,1,0,1
patrimony,0,0,0,0,1,0,1
flagship,0,0,0,0,1,0,1
macedonians,0,0,0,0,1,0,1
sivasubramanian,0,0,0,0,1,0,1
dhanalakshmi,0,0,0,0,1,0,1
lepers,0,0,0,0,1,0,1
messala,0,0,0,0,1,0,1
charioteer,0,0,0,0,1,0,1
ferocity,0,0,0,0,1,0,1
michinojo,0,0,0,0,1,0,1
iinuma,0,0,0,0,1,0,1
iguchi,0,0,0,0,1,0,1
kayano and ito,0,0,0,0,1,0,1
seibei,0,0,0,0,1,0,1
yogo,0,0,0,0,1,0,1
"tomoe, seibei",0,0,0,0,1,0,1
the boshin war,0,0,0,0,1,0,1
valerius,0,0,0,0,1,0,1
judah,0,0,0,0,1,0,1
harareet,0,0,0,0,1,0,1
stumble,0,0,0,0,1,0,1
sheik,0,0,0,0,1,0,1
ilderim,0,0,0,0,1,0,1
balthasar,0,0,0,0,1,0,1
tribune,0,0,0,0,1,0,1
barman,0,0,0,0,1,0,1
ericson,0,0,0,0,1,0,1
gunfighter,0,0,0,0,1,0,1
comradesthe,0,0,0,0,1,0,1
indio,0,0,0,0,1,0,1
multan,0,0,0,0,1,0,1
plot|datethe,0,0,0,0,1,0,1
mound,0,0,0,0,1,0,1
sacrificethe,0,0,0,0,1,0,1
muzaffarabadthe,0,0,0,0,1,0,1
heroismepilogue,0,0,0,0,1,0,1
breakoutthe aftermaththe nightthe wild chase,0,0,0,0,1,0,1
interventionsaluting,0,0,0,0,1,0,1
stepsinitial,0,0,0,0,1,0,1
realizationthe,0,0,0,0,1,0,1
aftermaththe,0,0,0,0,1,0,1
pak,0,0,0,0,1,0,1
powshope,0,0,0,0,1,0,1
nightunparalleled,0,0,0,0,1,0,1
blur,0,0,0,0,1,0,1
gurtu,0,0,0,0,1,0,1
outdraws,0,0,0,0,1,0,1
jennings rifle company volcanic rifle,0,0,0,0,1,0,1
cavanagh,0,0,0,0,1,0,1
furor,0,0,0,0,1,0,1
gunbelt,0,0,0,0,1,0,1
pocketwatch,0,0,0,0,1,0,1
mortimer,0,0,0,0,1,0,1
rocks,0,0,0,0,1,0,1
chime,0,0,0,0,1,0,1
tucumcari,0,0,0,0,1,0,1
el paso,0,0,0,0,1,0,1
white rocks,0,0,0,0,1,0,1
agua caliente,0,0,0,0,1,0,1
guy calloway,0,0,0,0,1,0,1
caliente,0,0,0,0,1,0,1
manco,0,0,0,0,1,0,1
paso,0,0,0,0,1,0,1
membership,0,0,0,0,1,0,1
butting,0,0,0,0,1,0,1
eastwood,0,0,0,0,1,0,1
nightthe,0,0,0,0,1,0,1
jails,0,0,0,0,1,0,1
congratulates,0,0,0,0,1,0,1
breakoutthe,0,0,0,0,1,0,1
sudevan,0,0,0,0,1,0,1
ventilator,0,0,0,0,1,0,1
abel,0,0,0,0,1,0,1
rajeev,0,0,0,0,1,0,1
sidharth,0,0,0,0,1,0,1
kochi,0,0,0,0,1,0,1
superstar,0,0,0,0,1,0,1
rahman,0,0,0,0,1,0,1
nazar,0,0,0,0,1,0,1
ajmal,0,0,0,0,1,0,1
junction,0,0,0,0,1,0,1
shinbone,0,0,0,0,1,0,1
stoddard and peabody,0,0,0,0,1,0,1
cattleman,0,0,0,0,1,0,1
favorite,0,0,0,0,1,0,1
hallie,0,0,0,0,1,0,1
doniphon,0,0,0,0,1,0,1
palakkad,0,0,0,0,1,0,1
d'souza,0,0,0,0,1,0,1
complexity,0,0,0,0,1,0,1
motherhood,0,0,0,0,1,0,1
camparrival,0,0,0,0,1,0,1
repatriation,0,0,0,0,1,0,1
muzaffarabadthe sacrificethe,0,0,0,0,1,0,1
successthe,0,0,0,0,1,0,1
reasonthe,0,0,0,0,1,0,1
hopethe,0,0,0,0,1,0,1
remittance,0,0,0,0,1,0,1
soman and lakshmi,0,0,0,0,1,0,1
raihan,0,0,0,0,1,0,1
explanations,0,0,0,0,1,0,1
soman,0,0,0,0,1,0,1
janu,0,0,0,0,1,0,1
raju and janu,0,0,0,0,1,0,1
connivance,0,0,0,0,1,0,1
kaniyan,0,0,0,0,1,0,1
commisoner,0,0,0,0,1,0,1
bhuvana,0,0,0,0,1,0,1
gilli309.jpg|thumb|left|200px|velu,0,0,0,0,1,0,1
fitzcarraldo,0,0,0,0,1,0,1
marietta,0,0,0,0,1,0,1
the rock river bridge,0,0,0,0,1,0,1
infantryman,0,0,0,0,1,0,1
chattanooga,0,0,0,0,1,0,1
era.{{cite,0,0,0,0,1,0,1
fort sedgewick,0,0,0,0,1,0,1
wolves,0,0,0,0,1,0,1
pawnee,0,0,0,0,1,0,1
citation,0,0,0,0,1,0,1
mexican pacific,1,0,0,0,0,0,1
kicking,0,0,0,0,1,0,1
spivey,0,0,0,0,1,0,1
baur,0,0,0,0,1,0,1
dances,0,0,0,0,1,0,1
bears,0,0,0,0,1,0,1
sioux,0,0,0,0,1,0,1
migrating,0,0,0,0,1,0,1
disrepair,0,0,0,0,1,0,1
hijacker,0,0,0,0,1,0,1
boneshaker,0,0,0,0,1,0,1
ghilli,0,0,0,0,1,0,1
reversal,0,0,0,0,1,0,1
joshamee,0,0,0,0,1,0,1
weatherby,0,0,0,0,1,0,1
norrington,0,0,0,0,1,0,1
shipwreck,0,0,0,0,1,0,1
seafloor,0,0,0,0,1,0,1
corset,0,0,0,0,1,0,1
bootstrap,0,0,0,0,1,0,1
parley,0,0,0,0,1,0,1
port royal,0,0,0,0,1,0,1
sparrow,0,0,0,0,1,0,1
tortuga,0,0,0,0,1,0,1
barbossa,0,0,0,0,1,0,1
gibbs,0,0,0,0,1,0,1
dauntless,0,0,0,0,1,0,1
handcar,0,0,0,0,1,0,1
western & atlantic railroad,0,0,0,0,1,0,1
flatcar,0,0,0,0,1,0,1
cisco,0,0,0,0,1,0,1
forepaw,0,0,0,0,1,0,1
stands with a fist,0,0,0,0,1,0,1
fort sedgwick,0,0,0,0,1,0,1
les blank }} using,0,0,0,0,1,0,1
archiveurl,0,0,0,0,1,0,1
the ucayali river,0,0,0,0,1,0,1
rapid,0,0,0,0,1,0,1
ucayali,0,0,0,0,1,0,1
portage,0,0,0,0,1,0,1
trans,0,0,0,0,1,0,1
next.<ref,0,0,0,0,1,0,1
herzog's,0,0,0,0,1,0,1
trans-andean,0,0,0,0,1,0,1
peruvian,0,0,0,0,1,0,1
the pachitea river,0,0,0,0,1,0,1
amazon,0,0,0,0,1,0,1
°,0,0,0,0,1,0,1
enrico,0,0,0,0,1,0,1
pulley,0,0,0,0,1,0,1
peru,0,0,0,0,1,0,1
orinoco,0,0,0,0,1,0,1
pachitea,0,0,0,0,1,0,1
tributary,0,0,0,0,1,0,1
alluri,0,0,0,0,1,0,1
sgt,0,0,0,0,1,0,1
observe,0,0,0,0,1,0,1
socks,0,0,0,0,1,0,1
rout,0,0,0,0,1,0,1
stands,0,0,0,0,1,0,1
dunbar,0,0,0,0,1,0,1
cruelity,0,0,0,0,1,0,1
cinematic,0,0,0,0,1,0,1
herzog,0,0,0,0,1,0,1
sitaramaraju,0,0,0,0,1,0,1
iquitos,0,0,0,0,1,0,1
caruso,0,0,0,0,1,0,1
rubber,0,0,0,0,1,0,1
underwriting,0,0,0,0,1,0,1
fjord press,0,0,0,0,1,0,1
dreams,0,0,0,0,1,0,1
rum,0,0,0,0,1,0,1
shockwave,0,0,0,0,1,0,1
isla de muerta,0,0,0,0,1,0,1
brahmanyam,0,0,0,0,1,0,1
kulappully,0,0,0,0,1,0,1
ornament,0,0,0,0,1,0,1
astrologer,0,0,0,0,1,0,1
jagannadhan,0,0,0,0,1,0,1
ayinikad,0,0,0,0,1,0,1
keezhpayoor,0,0,0,0,1,0,1
thamburan,0,0,0,0,1,0,1
brahmadathan,0,0,0,0,1,0,1
appan,0,0,0,0,1,0,1
unnimaya,0,0,0,0,1,0,1
nayanthara,0,0,0,0,1,0,1
abey,0,0,0,0,1,0,1
nandakumar,0,0,0,0,1,0,1
kanimangalam,0,0,0,0,1,0,1
kulappully appan thamburan,0,0,0,0,1,0,1
yagyopaveetham,0,0,0,0,1,0,1
kaloor,0,0,0,0,1,0,1
mana,0,0,0,0,1,0,1
namboothiri,0,0,0,0,1,0,1
jagannathan,0,0,0,0,1,0,1
naina,0,0,0,0,1,0,1
muthupandi’s,0,0,0,0,1,0,1
velu-,0,0,0,0,1,0,1
nagant,0,0,0,0,1,0,1
ruskeala,0,0,0,0,1,0,1
karelia,0,0,0,0,1,0,1
gunner,0,0,0,0,1,0,1
vaskov,0,0,0,0,1,0,1
gadget,0,0,0,0,1,0,1
binami,0,0,0,0,1,0,1
insecure,0,0,0,0,1,0,1
shivaji,0,0,0,0,1,0,1
chatrapati,0,0,0,0,1,0,1
terminus,0,0,0,0,1,0,1
runway,0,0,0,0,1,0,1
perish,0,0,0,0,1,0,1
prakash,0,0,0,0,1,0,1
deity,0,0,0,0,1,0,1
registration,0,0,0,0,1,0,1
isla,0,0,0,0,1,0,1
kulappully appan's,0,0,0,0,1,0,1
german grand prix,0,0,0,0,1,0,1
the 1976,0,0,0,0,1,0,1
niki,0,0,0,0,1,0,1
nürburgring,0,0,0,0,1,0,1
fuji,0,0,0,0,1,0,1
world championship at fuji,0,0,0,0,1,0,1
formula one,0,0,0,0,1,0,1
black pearl,0,0,0,0,1,0,1
barter,0,0,0,0,1,0,1
jamaica,0,0,0,0,1,0,1
the hms interceptor,0,0,0,0,1,0,1
the black pearl,0,0,0,0,1,0,1
swann,0,0,0,0,1,0,1
muerta,0,0,0,0,1,0,1
pulse,0,0,0,0,1,0,1
the pirate code,0,0,0,0,1,0,1
commodore,0,0,0,0,1,0,1
lauda,0,0,0,0,1,0,1
immedietley,0,0,0,0,1,0,1
hridoy,0,0,0,0,1,0,1
makabe,0,0,0,0,1,0,1
dathan,0,0,0,0,1,0,1
jagan,0,0,0,0,1,0,1
nandan,0,0,0,0,1,0,1
the kaloor brahmadathan namboothiri,0,0,0,0,1,0,1
kali,0,0,0,0,1,0,1
misa,0,0,0,0,1,0,1
hayakawa,0,0,0,0,1,0,1
uehara,0,0,0,0,1,0,1
misha,0,0,0,0,1,0,1
ryō,0,0,0,0,1,0,1
matashichi,0,0,0,0,1,0,1
rokurota,0,0,0,0,1,0,1
akizuki,0,0,0,0,1,0,1
tahei,0,0,0,0,1,0,1
sawdagar,0,0,0,0,1,0,1
heartedness,0,0,0,0,1,0,1
whispering,0,0,0,0,1,0,1
hannasseys,0,0,0,0,1,0,1
julie,0,0,0,0,1,0,1
raja rathnam,0,0,0,0,1,0,1
stepbrother,0,0,0,0,1,0,1
muthu lakshmi ammal,0,0,0,0,1,0,1
raja rathnam pillai,0,0,0,0,1,0,1
rajamanikyam,0,0,0,0,1,0,1
gatewood,0,0,0,0,1,0,1
tonto,0,0,0,0,1,0,1
dry,0,0,0,0,1,0,1
objecting,0,0,0,0,1,0,1
plummers,0,0,0,0,1,0,1
boone,0,0,0,0,1,0,1
handcuff,0,0,0,0,1,0,1
arizona territory,0,0,0,0,1,0,1
wilcox,0,0,0,0,1,0,1
warpath,0,0,0,0,1,0,1
lordsburg,0,0,0,0,1,0,1
mitchell,0,0,0,0,1,0,1
"the ""war for southern independence",0,0,0,0,1,0,1
ammal,0,0,0,0,1,0,1
nadar,0,0,0,0,1,0,1
ima,0,0,0,0,1,0,1
raja rathnam's,0,0,0,0,1,0,1
rights,0,0,0,0,1,0,1
vere,0,0,0,0,1,0,1
captain vere,0,0,0,0,1,0,1
abdication,0,0,0,0,1,0,1
rigging,0,0,0,0,1,0,1
gruel,0,0,0,0,1,0,1
the rights of war,0,0,0,0,1,0,1
yonder,0,0,0,0,1,0,1
claggart,0,0,0,0,1,0,1
yardarm,0,0,0,0,1,0,1
flogging,0,0,0,0,1,0,1
rajasel,0,0,0,0,1,0,1
rathnam,0,0,0,0,1,0,1
bellary,0,0,0,0,1,0,1
south kerala,0,0,0,0,1,0,1
muthu lakshmi,0,0,0,0,1,0,1
rajaselvam,0,0,0,0,1,0,1
blanchard,0,0,0,0,1,0,1
geronimo,0,0,0,0,1,0,1
plummer,0,0,0,0,1,0,1
"the ""war of the rebellion",0,0,0,0,1,0,1
conscript,0,0,0,0,1,0,1
mourns,0,0,0,0,1,0,1
katsumoto,0,0,0,0,1,0,1
nobutada,0,0,0,0,1,0,1
imperial japanese,0,0,0,0,1,0,1
hirotaro,0,0,0,0,1,0,1
the battle of thermopylae,0,0,0,0,1,0,1
thermopylae,0,0,0,0,1,0,1
leading,0,0,0,0,1,0,1
bushido,0,0,0,0,1,0,1
meiji,0,0,0,0,1,0,1
point 5179,0,0,0,0,1,0,1
vantage,0,0,0,0,1,0,1
the indian military academy,0,0,0,0,1,0,1
lakshya,0,0,0,0,1,0,1
shergill,0,0,0,0,1,0,1
3rd,0,0,0,0,1,0,1
omura,0,0,0,0,1,0,1
gant,0,0,0,0,1,0,1
ujio,0,0,0,0,1,0,1
doc boone,0,0,0,0,1,0,1
bancroft,0,0,0,0,1,0,1
the ringo kid,0,0,0,0,1,0,1
apache,0,0,0,0,1,0,1
the union army,0,0,0,0,1,0,1
dry fork,0,0,0,0,1,0,1
new mexico territory,0,0,0,0,1,0,1
apaches,0,0,0,0,1,0,1
mallory,0,0,0,0,1,0,1
bagley,0,0,0,0,1,0,1
peacock,0,0,0,0,1,0,1
hatfield,0,0,0,0,1,0,1
luke,0,0,0,0,1,0,1
algren,0,0,0,0,1,0,1
imperial army,0,0,0,0,1,0,1
zebulon,0,0,0,0,1,0,1
taka,0,0,0,0,1,0,1
squeak,0,0,0,0,1,0,1
shipmate,0,0,0,0,1,0,1
flavor,0,0,0,0,1,0,1
substitution,0,0,0,0,1,0,1
destiny island,1,0,0,0,0,0,1
hornet,0,0,0,0,1,0,1
riverbank,0,0,0,0,1,0,1
fulfillment,0,0,0,0,1,0,1
arrowhead,0,0,0,0,1,0,1
jaguar paw,0,0,0,0,1,0,1
maize,0,0,0,0,1,0,1
hunted,0,0,0,0,1,0,1
bludgeon,0,0,0,0,1,0,1
pross,0,0,0,0,1,0,1
ernest,0,0,0,0,1,0,1
darnay,0,0,0,0,1,0,1
barsad,0,0,0,0,1,0,1
cleverness,0,0,0,0,1,0,1
manette,0,0,0,0,1,0,1
the english channel,0,0,0,0,1,0,1
defarge,0,0,0,0,1,0,1
smoke frog,0,0,0,0,1,0,1
vine,0,0,0,0,1,0,1
coating,0,0,0,0,1,0,1
kukulkan,0,0,0,0,1,0,1
amazement,0,0,0,0,1,0,1
cocoa,0,0,0,0,1,0,1
quarry,0,0,0,0,1,0,1
drunkards,0,0,0,0,1,0,1
cut rock,0,0,0,0,1,0,1
cut rock's,0,0,0,0,1,0,1
next,0,0,0,0,1,0,1
middle eye,0,0,0,0,1,0,1
blunted,0,0,0,0,1,0,1
subdue,0,0,0,0,1,0,1
hunting,0,0,0,0,1,0,1
tapir,0,0,0,0,1,0,1
mesoamerican,0,0,0,0,1,0,1
paw,0,0,0,0,1,0,1
atlatls,0,0,0,0,1,0,1
curl,0,0,0,0,1,0,1
aristocrat,0,0,0,0,1,0,1
woods,0,0,0,0,1,0,1
cynicism,0,0,0,0,1,0,1
the french revolution,0,0,0,0,1,0,1
cherokee,0,0,0,0,1,0,1
militia,0,0,0,0,1,0,1
union militia,0,0,0,0,1,0,1
josey,0,0,0,0,1,0,1
fletcher,0,0,0,0,1,0,1
gatling,0,0,0,0,1,0,1
santa rio,0,0,0,0,1,0,1
bushwhackers,0,0,0,0,1,0,1
pro-union jayhawkers,0,0,0,0,1,0,1
monterrey,0,0,0,0,1,0,1
redlegs,0,0,0,0,1,0,1
texas rangers,0,0,0,0,1,0,1
comancheros,0,0,0,0,1,0,1
watie,0,0,0,0,1,0,1
budd,0,0,0,0,1,0,1
fairfax,0,0,0,0,1,0,1
murderers,0,0,0,0,1,0,1
jayhawkers,0,0,0,0,1,0,1
noland,0,0,0,0,1,0,1
volleyball,0,0,0,0,1,0,1
kelly frears,0,0,0,0,1,0,1
marquis,0,0,0,0,1,0,1
evremonde,0,0,0,0,1,0,1
evremondes,0,0,0,0,1,0,1
seamstress,0,0,0,0,1,0,1
bastille,0,0,0,0,1,0,1
madame guillotine,0,0,0,0,1,0,1
carton,0,0,0,0,1,0,1
frears,0,0,0,0,1,0,1
pickup,0,0,0,0,1,0,1
productivity,0,0,0,0,1,0,1
fedex,0,0,0,0,1,0,1
wilson sporting goods,0,0,0,0,1,0,1
goods,0,0,0,0,1,0,1
loincloth,0,0,0,0,1,0,1
locator,0,0,0,0,1,0,1
illustration,0,0,0,0,1,0,1
romi,0,0,0,0,1,0,1
nh1d.,0,0,0,0,1,0,1
leech,0,0,0,0,1,0,1
tishkoff,0,0,0,0,1,0,1
incineration,0,0,0,0,1,0,1
mgm,0,0,0,0,1,0,1
safekeeping,0,0,0,0,1,0,1
ventilation,0,0,0,0,1,0,1
palestinian,0,0,0,0,1,0,1
olive,0,0,0,0,1,0,1
west bank,0,0,0,0,1,0,1
morrar,0,0,0,0,1,0,1
ayed,0,0,0,0,1,0,1
jordana,0,0,0,0,1,0,1
bacha,0,0,0,0,1,0,1
fatah,0,0,0,0,1,0,1
ramification,0,0,0,0,1,0,1
budrus,0,0,0,0,1,0,1
the jewish daily forward,0,0,0,0,1,0,1
gildoy,0,0,0,0,1,0,1
lord gildoy,0,0,0,0,1,0,1
electronics,0,0,0,0,1,0,1
caldwell,0,0,0,0,1,0,1
kargil,0,0,0,0,1,0,1
familiarity,0,0,0,0,1,0,1
basher,0,0,0,0,1,0,1
mgm grand,0,0,0,0,1,0,1
reuben,0,0,0,0,1,0,1
linus,0,0,0,0,1,0,1
bruiser,0,0,0,0,1,0,1
logo,0,0,0,0,1,0,1
tarr,0,0,0,0,1,0,1
malloy,0,0,0,0,1,0,1
rusty,0,0,0,0,1,0,1
amazing,0,0,0,0,1,0,1
livingston,0,0,0,0,1,0,1
benedict,0,0,0,0,1,0,1
bellagio,0,0,0,0,1,0,1
judgement,0,0,0,0,1,0,1
the nevada gaming commission,0,0,0,0,1,0,1
dell,0,0,0,0,1,0,1
advertising,0,0,0,0,1,0,1
emissary,0,0,0,0,1,0,1
personage,0,0,0,0,1,0,1
monmouth,0,0,0,0,1,0,1
dereliction,0,0,0,0,1,0,1
chidambaram,0,0,0,0,1,0,1
v.,0,0,0,0,1,0,1
vijayakumar,0,0,0,0,1,0,1
referee,0,0,0,0,1,0,1
tara,0,0,0,0,1,0,1
parentage,0,0,0,0,1,0,1
the academy &,0,0,0,0,1,0,1
jayachitra,0,0,0,0,1,0,1
enquires,0,0,0,0,1,0,1
hallorann,0,0,0,0,0,1,1
bourbon,0,0,0,0,0,1,1
binge,0,0,0,0,0,1,1
orientation,0,0,0,0,0,1,1
reɑяum,0,0,0,0,0,1,1
ullman,0,0,0,0,0,1,1
shine,0,0,0,0,0,1,1
cascade,0,0,0,0,0,1,1
vishwanath,0,0,0,0,1,0,1
sumitra,0,0,0,0,1,0,1
bailout,0,0,0,0,1,0,1
the monmouth rebellion,0,0,0,0,1,0,1
whim,0,0,0,0,1,0,1
sojourn,0,0,0,0,1,0,1
indies,0,0,0,0,1,0,1
willoughby,0,0,0,0,1,0,1
jeffreys,0,0,0,0,1,0,1
levasseur,0,0,0,0,1,0,1
emancipation,0,0,0,0,1,0,1
piracy,0,0,0,0,1,0,1
nirosha,0,0,0,0,1,0,1
the west indies,0,0,0,0,1,0,1
glorious,0,0,0,0,1,0,1
arabella,0,0,0,0,1,0,1
assizes,0,0,0,0,1,0,1
the glorious revolution,0,0,0,0,1,0,1
berates,0,0,0,0,1,0,1
ramaswamy,0,0,0,0,1,0,1
saul,0,0,0,0,1,0,1
catton,0,0,0,0,1,0,1
escalante,0,0,0,0,1,0,1
vaudeville,0,0,0,0,1,0,1
feroz,0,0,0,0,1,0,1
suchek,0,0,0,0,1,0,1
cloverleaf,0,0,0,0,1,0,1
the acme corporation,0,0,0,0,1,0,1
weasel,0,0,0,0,1,0,1
reappearing,0,0,0,0,1,0,1
dolores,0,0,0,0,1,0,1
acme,0,0,0,0,1,0,1
the toon patrol,0,0,0,0,1,0,1
sprayer,0,0,0,0,1,0,1
toontown,0,0,0,0,1,0,1
dip,0,0,0,0,1,0,1
maroon,0,0,0,0,1,0,1
cloverleaf industries,0,0,0,0,1,0,1
electric,0,0,0,0,1,0,1
valiant,0,0,0,0,1,0,1
solvent,0,0,0,0,1,0,1
rajashekhar,0,0,0,0,1,0,1
imtiyaz,0,0,0,0,1,0,1
zameer,0,0,0,0,1,0,1
undergarment,0,0,0,0,1,0,1
sector,0,0,0,0,1,0,1
the 3rd battalion of the punjab regiment,0,0,0,0,1,0,1
damle,0,0,0,0,1,0,1
salesgirl,0,0,0,0,1,0,1
rosebush,0,0,0,0,1,0,1
sarada,0,0,0,0,1,0,1
dileep,0,0,0,0,1,0,1
hater,0,0,0,0,1,0,1
hq,0,0,0,0,1,0,1
the mumbai police department,0,0,0,0,1,0,1
jatin,0,0,0,0,1,0,1
jeeva,0,0,0,0,1,0,1
rookie,0,0,0,0,1,0,1
siddiqui,0,0,0,0,1,0,1
yashpal,0,0,0,0,1,0,1
agashe,0,0,0,0,1,0,1
toon,0,0,0,0,1,0,1
pacific electric,0,0,0,0,1,0,1
yen,0,0,0,0,1,0,1
cloverleaf and acme's,0,0,0,0,1,0,1
donut,0,0,0,0,1,0,1
turmoil,0,0,0,0,1,0,1
guzheng,0,0,0,0,1,0,1
sty,0,0,0,0,1,0,1
pulpit,0,0,0,0,1,0,1
qi,0,0,0,0,1,0,1
the iron fist,0,0,0,0,1,0,1
the axe gang,0,0,0,0,1,0,1
thandavan,0,0,0,0,1,0,1
aghori,0,0,0,0,1,0,1
arya,0,0,0,0,1,0,1
hamsavalli,0,0,0,0,1,0,1
malayali,0,0,0,0,1,0,1
moksha,0,0,0,0,1,0,1
rudran,0,0,0,0,1,0,1
deformative,0,0,0,0,1,0,1
s.w.a.t.,0,0,0,0,1,0,1
mug,0,0,0,0,1,0,1
convalescence,0,0,0,0,1,0,1
metamorphosis,0,0,0,0,1,0,1
bump,0,0,0,0,1,0,1
costar,0,0,0,0,1,0,1
maroon cartoon,0,0,0,0,1,0,1
toons,0,0,0,0,1,0,1
mixture,0,0,0,0,1,0,1
gag,0,0,0,0,1,0,1
the beast,0,0,0,0,1,0,1
pamphlet,0,0,0,0,1,0,1
flow,0,0,0,0,1,0,1
picking,0,0,0,0,1,0,1
toad technique,0,0,0,0,1,0,1
shanghai,0,0,0,0,1,0,1
manual,0,0,0,0,1,0,1
hexagon,0,0,0,0,1,0,1
harpists,0,0,0,0,1,0,1
kicks,0,0,0,0,1,0,1
the buddhist palm,0,0,0,0,1,0,1
atlatl,0,0,0,0,1,0,1
impudence,0,0,0,0,1,0,1
dart,0,0,0,0,1,0,1
daigoro,0,0,0,0,1,0,1
turncoat,0,0,0,0,1,0,1
finishing,0,0,0,0,1,0,1
shinobi,0,0,0,0,1,0,1
axle,0,0,0,0,1,0,1
ittō,0,0,0,0,1,0,1
mogaribue,0,0,0,0,1,0,1
akari yagyū,0,0,0,0,1,0,1
emerge,0,0,0,0,1,0,1
mace,0,0,0,0,1,0,1
hidari,0,0,0,0,1,0,1
keeping,0,0,0,0,1,0,1
fishnet,0,0,0,0,1,0,1
kogi,0,0,0,0,1,0,1
frisbees,0,0,0,0,1,0,1
shove,0,0,0,0,1,0,1
spray,0,0,0,0,1,0,1
heap,0,0,0,0,1,0,1
ogami,0,0,0,0,1,0,1
kurokawa,0,0,0,0,1,0,1
turtles,0,0,0,0,1,0,1
dune,0,0,0,0,1,0,1
sire,0,0,0,0,1,0,1
the merry men's,0,0,0,0,1,0,1
the king of england,0,0,0,0,1,0,1
crusades,0,0,0,0,1,0,1
lionheart,0,0,0,0,1,0,1
angevin,0,0,0,0,1,0,1
archery,0,0,0,0,1,0,1
friar,0,0,0,0,1,0,1
gauge,0,0,0,0,1,0,1
dye,0,0,0,0,1,0,1
indigo,0,0,0,0,1,0,1
daikon,0,0,0,0,1,0,1
naginata,0,0,0,0,1,0,1
breast,0,0,0,0,1,0,1
aware,0,0,0,0,1,0,1
yagyū,0,0,0,0,1,0,1
hidaris,0,0,0,0,1,0,1
sayaka,0,0,0,0,1,0,1
kaishakunin,0,0,0,0,1,0,1
akari,0,0,0,0,1,0,1
ogami ittō,0,0,0,0,1,0,1
shingen,0,0,0,0,1,0,1
volley,0,0,0,0,1,0,1
broken,0,0,0,0,1,0,1
the warring states period,0,0,0,0,1,0,1
shi,0,0,0,0,1,0,1
qin,0,0,0,0,1,0,1
china,0,0,0,0,1,0,1
prefect,0,0,0,0,1,0,1
weiqi,0,0,0,0,1,0,1
flying snow,0,0,0,0,1,0,1
calligraphy,0,0,0,0,1,0,1
huang,0,0,0,0,1,0,1
bias,0,0,0,0,1,0,1
killer.{{cite,0,0,0,0,1,0,1
glenwood springs,0,0,0,0,1,0,1
fabian,0,0,0,0,1,0,1
emporium,0,0,0,0,1,0,1
nobukado,0,0,0,0,1,0,1
wakashū,0,0,0,0,1,0,1
spies,0,0,0,0,1,0,1
nobunaga,0,0,0,0,1,0,1
tromps,0,0,0,0,1,0,1
kurokawas,0,0,0,0,1,0,1
counterattack,0,0,0,0,1,0,1
oda,0,0,0,0,1,0,1
the battle of nagashino,0,0,0,0,1,0,1
kagemusha,0,0,0,0,1,0,1
lake suwa,0,0,0,0,1,0,1
suwa,0,0,0,0,1,0,1
ieyasu,0,0,0,0,1,0,1
the battle of takatenjin,0,0,0,0,1,0,1
nagashino,0,0,0,0,1,0,1
kagemusha{{'}}s,0,0,0,0,1,0,1
takeda,0,0,0,0,1,0,1
katsuyori,0,0,0,0,1,0,1
kagemushas,0,0,0,0,1,0,1
takatenjin,0,0,0,0,1,0,1
locksley,0,0,0,0,1,0,1
saxon,0,0,0,0,1,0,1
sherwood forest,0,0,0,0,1,0,1
portuguese,0,0,0,0,1,0,1
southampton,0,0,0,0,1,0,1
brock,0,0,0,0,1,0,1
marston,1,0,0,0,0,0,1
sank,0,0,0,0,1,0,1
bukater,0,0,0,0,1,0,1
chronicle,0,0,0,0,1,0,1
aloof,0,0,0,0,1,0,1
dewitt,0,0,0,0,1,0,1
hockley,0,0,0,0,1,0,1
bukaters,0,0,0,0,1,0,1
calvert,0,0,0,0,1,0,1
flare,0,0,0,0,1,0,1
lowe,0,0,0,0,1,0,1
stateroom,0,0,0,0,1,0,1
lizzy,0,0,0,0,1,0,1
topsail,0,0,0,0,1,0,1
manuel,0,0,0,0,1,0,1
rose's,0,0,0,0,1,0,1
mock,0,0,0,0,1,0,1
dresser,0,0,0,0,1,0,1
ranching,0,0,0,0,1,0,1
rufus hannassey,0,0,0,0,1,0,1
maragon,0,0,0,0,1,0,1
terrills,0,0,0,0,1,0,1
muddy,0,0,0,0,1,0,1
manhood,0,0,0,0,1,0,1
foreman,0,0,0,0,1,0,1
hannassey,0,0,0,0,1,0,1
patricia and terrill,0,0,0,0,1,0,1
lower,0,0,0,0,1,0,1
mckay,0,0,0,0,1,0,1
the terrill-hannassey,0,0,0,0,1,0,1
dawson,0,0,0,0,1,0,1
evade,0,0,0,0,1,0,1
the dewitt bukaters',0,0,0,0,1,0,1
cal,0,0,0,0,1,0,1
caledon,0,0,0,0,1,0,1
cushman,0,0,0,0,1,0,1
newfoundland,0,0,0,0,1,0,1
dickon malbete,0,0,0,0,1,0,1
cheyne,0,0,0,0,1,0,1
gaja,0,0,0,0,1,0,1
shwetha,0,0,0,0,1,0,1
midea,0,0,0,0,1,0,1
kilea,0,0,0,0,1,0,1
quarterstaff,0,0,0,0,1,0,1
scarlet,0,0,0,0,1,0,1
dickon,0,0,0,0,1,0,1
tuck,0,0,0,0,1,0,1
the bishop of the black canons,0,0,0,0,1,0,1
normans,0,0,0,0,1,0,1
gisbourne,0,0,0,0,1,0,1
canons,0,0,0,0,1,0,1
guile,0,0,0,0,1,0,1
sherwood,0,0,0,0,1,0,1
nottingham,0,0,0,0,1,0,1
malbete,0,0,0,0,1,0,1
marian,0,0,0,0,1,0,1
darling,0,0,0,0,1,0,1
devendra,0,0,0,0,1,0,1
pregnant,0,0,0,0,1,0,1
canvas,0,0,0,0,1,0,1
trans-atlantic,0,0,0,0,1,0,1
steamship,0,0,0,0,1,0,1
captain troop's,0,0,0,0,1,0,1
the jennie cushman,0,0,0,0,1,0,1
the grand banks of newfoundland,0,0,0,0,1,0,1
jennie,0,0,0,0,1,0,1
fidello,0,0,0,0,1,0,1
disko,0,0,0,0,1,0,1
gulabo,0,0,0,0,1,0,1
joravar,0,0,0,0,1,0,1
jaildar,0,0,0,0,1,0,1
jasbinder,0,0,0,0,1,0,1
choudhary,0,0,0,0,1,0,1
shamsher,0,0,0,0,1,0,1
bebo,0,0,0,0,1,0,1
jagga,0,0,0,0,1,0,1
o.k.,0,0,0,0,1,0,1
ike,0,0,0,0,1,0,1
accommodation,0,0,0,0,1,0,1
abilene,0,0,0,0,1,0,1
comanches,0,0,0,0,1,0,1
yankee,0,0,0,0,1,0,1
futterman,0,0,0,0,1,0,1
mccorry,0,0,0,0,1,0,1
mose,0,0,0,0,1,0,1
debbie,0,0,0,0,1,0,1
jorgensens,0,0,0,0,1,0,1
bracelet,0,0,0,0,1,0,1
flour,0,0,0,0,1,0,1
the red river,0,0,0,0,1,0,1
millay,0,0,0,0,1,0,1
garth,0,0,0,0,1,0,1
clatter,0,0,0,0,1,0,1
groot,0,0,0,0,1,0,1
wayfarer,0,0,0,0,1,0,1
chisholm,0,0,0,0,1,0,1
dunson to abilene,0,0,0,0,1,0,1
rev.,0,0,0,0,1,0,1
amc television,0,0,0,0,1,0,1
searchers,0,0,0,0,1,0,1
jordan,0,0,0,0,1,0,1
pc,0,0,0,0,1,0,1
alibi,0,0,0,0,1,0,1
comanche,0,0,0,0,1,0,1
confederacy,0,0,0,0,1,0,1
edwards,0,0,0,0,1,0,1
the texas rangers,0,0,0,0,1,0,1
the searchers special,0,0,0,0,1,0,1
trading,0,0,0,0,1,0,1
harper,0,0,0,0,1,0,1
homestead,0,0,0,0,1,0,1
amc,0,0,0,0,1,0,1
jorgensen,0,0,0,0,1,0,1
greenhill,0,0,0,0,1,0,1
pawley,0,0,0,0,1,0,1
oath,0,0,0,0,1,0,1
nawyecka,0,0,0,0,1,0,1
railhead,0,0,0,0,1,0,1
ireland,0,0,0,0,1,0,1
gloucestershire,0,0,0,0,1,0,1
dunson,0,0,0,0,1,0,1
sakaki,0,0,0,0,1,0,1
jubei,0,0,0,0,1,0,1
yamashiro,0,0,0,0,1,0,1
the devils of kimon,0,0,0,0,1,0,1
gemma,0,0,0,0,1,0,1
shimoda,0,0,0,0,1,0,1
kibagami,0,0,0,0,1,0,1
the devil shijima,0,0,0,0,1,0,1
hyobu,0,0,0,0,1,0,1
shinkuro,0,0,0,0,1,0,1
"jubei, kagero",0,0,0,0,1,0,1
golem,0,0,0,0,1,0,1
toyotomi,0,0,0,0,1,0,1
unite,0,0,0,0,1,0,1
koga,0,0,0,0,1,0,1
mochizuki,0,0,0,0,1,0,1
dakuan,0,0,0,0,1,0,1
himuro,0,0,0,0,1,0,1
employ,0,0,0,0,1,0,1
bluff,0,0,0,0,1,0,1
nagorno,0,0,0,0,1,0,1
beef,0,0,0,0,1,0,1
nadine,0,0,0,0,1,0,1
evening post,0,0,0,0,1,0,1
armenians,0,0,0,0,1,0,1
karabakh,0,0,0,0,1,0,1
tbilisi,0,0,0,0,1,0,1
azerbaijani,0,0,0,0,1,0,1
the shogun of the dark,0,0,0,0,1,0,1
zakuro,0,0,0,0,1,0,1
kishima,0,0,0,0,1,0,1
shijima,0,0,0,0,1,0,1
kishima harbor,0,0,0,0,1,0,1
kagero,0,0,0,0,1,0,1
agenda,0,0,0,0,1,0,1
tessai,0,0,0,0,1,0,1
kimon,0,0,0,0,1,0,1
point break,0,0,0,0,1,0,1
butterman,0,0,0,0,1,0,1
creek,0,0,0,0,1,0,1
carcass,0,0,0,0,1,0,1
holliday,0,0,0,0,1,0,1
wyatt,0,0,0,0,1,0,1
drier,0,0,0,0,1,0,1
brutishness,0,0,0,0,1,0,1
bannon,0,0,0,0,1,0,1
bannons,0,0,0,0,1,0,1
liveliness,0,0,0,0,1,0,1
barroom,0,0,0,0,1,0,1
hud,0,0,0,0,1,0,1
lonnie,0,0,0,0,1,0,1
survey,0,0,0,0,1,0,1
cunning,0,0,0,0,1,0,1
fro,0,0,0,0,1,0,1
unfolding,0,0,0,0,1,0,1
vet,0,0,0,0,1,0,1
blowup,0,0,0,0,1,0,1
swig,0,0,0,0,1,0,1
stilwell,0,0,0,0,1,0,1
morgan,0,0,0,0,1,0,1
mattie,0,0,0,0,1,0,1
cowboys,0,0,0,0,1,0,1
ban,0,0,0,0,1,0,1
sanatorium,0,0,0,0,1,0,1
laudanum,0,0,0,0,1,0,1
earp,0,0,0,0,1,0,1
behan,0,0,0,0,1,0,1
mclaury,0,0,0,0,1,0,1
mcmasters,0,0,0,0,1,0,1
blaylock,0,0,0,0,1,0,1
mitchum,0,0,0,0,1,0,1
henry hooker,0,0,0,0,1,0,1
glenwood,0,0,0,0,1,0,1
clanton,0,0,0,0,1,0,1
sash,0,0,0,0,1,0,1
brocious,0,0,0,0,1,0,1
tucson,0,0,0,0,1,0,1
vermillion,0,0,0,0,1,0,1
viability,0,0,0,0,1,0,1
emptiness,0,0,0,0,1,0,1
nwa,0,0,0,0,1,0,1
falseness,0,0,0,0,1,0,1
peachy,0,0,0,0,1,0,1
gurkha,0,0,0,0,1,0,1
sikandergul,0,0,0,0,1,0,1
grandeur,0,0,0,0,1,0,1
policing,0,0,0,0,1,0,1
sandford,0,0,0,0,1,0,1
shopkeeper,0,0,0,0,1,0,1
spire,0,0,0,0,1,0,1
reload,0,0,0,0,1,0,1
somerfield,0,0,0,0,1,0,1
inquire,0,0,0,0,1,0,1
mockery,0,0,0,0,1,0,1
nicholas,0,0,0,0,1,0,1
motorway,0,0,0,0,1,0,1
bad,0,0,0,0,1,0,1
weaver,0,0,0,0,1,0,1
the sandford police service,0,0,0,0,1,0,1
booty,0,0,0,0,1,0,1
sikander,0,0,0,0,1,0,1
the arrow incident,0,0,0,0,1,0,1
mapping,0,0,0,0,1,0,1
recklessness,0,0,0,0,1,0,1
buyer,0,0,0,0,1,0,1
masonic,0,0,0,0,1,0,1
kipling,0,0,0,0,1,0,1
dravot,0,0,0,0,1,0,1
khyber,0,0,0,0,1,0,1
northern star,0,0,0,0,1,0,1
forswearing,0,0,0,0,1,0,1
heb,0,0,0,0,1,0,1
kukri,0,0,0,0,1,0,1
bashkai,0,0,0,0,1,0,1
kafiristan,0,0,0,0,1,0,1
kafu,0,0,0,0,1,0,1
selim,0,0,0,0,1,0,1
carnehan,0,0,0,0,1,0,1
kafu selim,0,0,0,0,1,0,1
hibernation,0,0,0,1,0,0,1
thereza,0,0,1,0,0,0,1
masculinity,0,0,0,1,0,0,1
globians,0,1,0,0,0,0,1
molyko,0,1,0,0,0,0,1
the molyko sport complex,0,1,0,0,0,0,1
volcanic sprint,0,1,0,0,0,0,1
globians film festival,0,1,0,0,0,0,1
bart,0,1,0,0,0,0,1
buea,0,1,0,0,0,0,1
the mount cameroon race of hope,0,1,0,0,0,0,1
the 2007,0,1,0,0,0,0,1
reliability,0,1,0,0,0,0,1
cameroon,0,1,0,0,0,0,1
dominique,0,1,0,0,0,0,1
southwest,0,1,0,0,0,0,1
ngwang,0,1,0,0,0,0,1
tedjojem,0,1,0,0,0,0,1
doorne,0,1,0,0,0,0,1
summit,0,1,0,0,0,0,1
mount cameroon,0,1,0,0,0,0,1
the southwest province,0,1,0,0,0,0,1
etonge,0,1,0,0,0,0,1
criticism,0,1,0,0,0,0,1
the dwarf gimli,1,0,0,0,0,0,1
dissenter,0,1,0,0,0,0,1
rarity,0,1,0,0,0,0,1
courtroom,0,1,0,0,0,0,1
sentence.<ref,0,1,0,0,0,0,1
rant,0,1,0,0,0,0,1
jurors,0,1,0,0,0,0,1
earlier.{{cite,0,1,0,0,0,0,1
angry,0,1,0,0,0,0,1
does.{{cite,0,1,0,0,0,0,1
diatribe,0,1,0,0,0,0,1
8–4,0,1,0,0,0,0,1
tally,0,1,0,0,0,0,1
entreaty,0,1,0,0,0,0,1
eyeglass,0,1,0,0,0,0,1
mwambo,0,1,0,0,0,0,1
tegan,0,1,0,0,0,0,1
elenore,0,1,0,0,0,0,1
chakadi,0,1,0,0,0,0,1
disagreement,0,1,0,0,0,0,1
griffith,0,1,0,0,0,0,1
grapefruit,0,1,0,0,0,0,1
expansion,0,1,0,0,0,0,1
the big bang,0,1,0,0,0,0,1
"aragorn, gimli",1,0,0,0,0,0,1
easel,0,1,0,0,0,0,1
galileo,0,1,0,0,0,0,1
parth,1,0,0,0,0,0,1
dwarves,1,0,0,0,0,0,1
mines of moria,1,0,0,0,0,0,1
the pharos lighthouse,0,1,0,0,0,0,1
milky,0,1,0,0,0,0,1
the elf arwen,1,0,0,0,0,0,1
jupiter,0,1,0,0,0,0,1
discord,0,1,0,0,0,0,1
mishra,0,1,0,0,0,0,1
elenore the carnivore,0,1,0,0,0,0,1
shama,0,1,0,0,0,0,1
abattoir.http://www.eormedia.com.au/films/teganthevegan/teganthevegan_images/articles/relax_mag_filmmakers_p4.pdf,0,1,0,0,0,0,1
carnivore,0,1,0,0,0,0,1
marisa,0,1,0,0,0,0,1
vegetarian,0,1,0,0,0,0,1
the canberra times,0,1,0,0,0,0,1
canberra,0,1,0,0,0,0,1
hd,0,1,0,0,0,0,1
the third reich,0,1,0,0,0,0,1
format,0,1,0,0,0,0,1
shama pradhan,0,1,0,0,0,0,1
harabou,0,1,0,0,0,0,1
rancour,0,1,0,0,0,0,1
baraju,0,1,0,0,0,0,1
netramani,0,1,0,0,0,0,1
the hobbit bilbo baggins,1,0,0,0,0,0,1
ballot,0,1,0,0,0,0,1
satyanarayana,0,1,0,0,0,0,1
sr,0,1,0,0,0,0,1
toed,0,1,0,0,0,0,1
tricia,0,1,0,0,0,0,1
pills,0,1,0,0,0,0,1
galen,1,0,0,0,0,0,1
roller,0,1,0,0,0,0,1
postmodern,0,1,0,0,0,0,1
wraith,1,0,0,0,0,0,1
transportation,0,1,0,0,0,0,1
bitterness,0,1,0,0,0,0,1
brahmanandam,0,1,0,0,0,0,1
evp,0,1,0,0,0,0,1
nudge,0,1,0,0,0,0,1
prebirths,0,1,0,0,0,0,1
vishwas,0,1,0,0,0,0,1
shantanu,0,1,0,0,0,0,1
salesperson,0,1,0,0,0,0,1
sudhir,0,1,0,0,0,0,1
parth galen,1,0,0,0,0,0,1
remorse,0,1,0,0,0,0,1
arcade,0,1,0,0,0,0,1
tarika,0,1,0,0,0,0,1
nepal,0,1,0,0,0,0,1
stongde,0,1,0,0,0,0,1
manali,0,1,0,0,0,0,1
lothlórien,1,0,0,0,0,0,1
zanskar,0,1,0,0,0,0,1
curriculum,0,1,0,0,0,0,1
sikkim,0,1,0,0,0,0,1
economics,0,1,0,0,0,0,1
abyss,1,0,0,0,0,0,1
dymotran,0,1,0,0,0,0,1
funplex,0,1,0,0,0,0,1
rink,0,1,0,0,0,0,1
modernist,0,1,0,0,0,0,1
compatibility,0,1,0,0,0,0,1
elf,1,0,0,0,0,0,1
sarpotdar,0,1,0,0,0,0,1
dhanajay,0,1,0,0,0,0,1
the elves galadriel and celeborn,1,0,0,0,0,0,1
lohars,0,1,0,0,0,0,1
"""film",0,1,0,0,0,0,1
gadia,0,1,0,0,0,0,1
chitoor,0,1,0,0,0,0,1
garh,0,1,0,0,0,0,1
maharanas,0,1,0,0,0,0,1
maharana,0,1,0,0,0,0,1
details,0,1,0,0,0,0,1
chanrdrawal,0,1,0,0,0,0,1
pratap,0,1,0,0,0,0,1
ram garh,0,1,0,0,0,0,1
database movie details,0,1,0,0,0,0,1
dera,0,1,0,0,0,0,1
ranjit,0,1,0,0,0,0,1
chandrawal,0,1,0,0,0,0,1
lakshmipathy,0,1,0,0,0,0,1
lohar,0,1,0,0,0,0,1
chittoor,0,1,0,0,0,0,1
parvati,0,1,0,0,0,0,1
chaudhary,0,1,0,0,0,0,1
madhuri,0,1,0,0,0,0,1
dhananjay and co,0,1,0,0,0,0,1
bali,0,1,0,0,0,0,1
manisha,0,1,0,0,0,0,1
dhananjay,0,1,0,0,0,0,1
sushma,0,1,0,0,0,0,1
kalbhor,0,1,0,0,0,0,1
lilabai,0,1,0,0,0,0,1
sachin,0,1,0,0,0,0,1
dhananjay and shantanu,0,1,0,0,0,0,1
tanu,0,1,0,0,0,0,1
parshuram,0,1,0,0,0,0,1
sudha,0,1,0,0,0,0,1
mane,0,1,0,0,0,0,1
jodha,0,1,0,0,0,0,1
ptolemy,0,1,0,0,0,0,1
claudius,0,1,0,0,0,0,1
paintings,0,1,0,0,0,0,1
adrenaline,1,0,0,0,0,0,1
poacher,0,1,0,0,0,0,1
esmarelda,1,0,0,0,0,0,1
venkatappa,0,1,0,0,0,0,1
nagarhole,0,1,0,0,0,0,1
nagarhole national,0,1,0,0,0,0,1
jody,1,0,0,0,0,0,1
kaimal,0,1,0,0,0,0,1
fortnight,0,1,0,0,0,0,1
griffith observatory,0,1,0,0,0,0,1
naxalite,0,1,0,0,0,0,1
ranjini,0,1,0,0,0,0,1
ramachandra,0,1,0,0,0,0,1
revathy,0,1,0,0,0,0,1
bhaskaran,0,1,0,0,0,0,1
disrespect,0,1,0,0,0,0,1
sakthivelu,0,1,0,0,0,0,1
naika,0,1,0,0,0,0,1
him.{{cite,0,1,0,0,0,0,1
hash,1,0,0,0,0,0,1
tunis,0,1,0,0,0,0,1
perrella,0,1,0,0,0,0,1
vincenzo,0,1,0,0,0,0,1
bertie,0,1,0,0,0,0,1
kingwell,0,1,0,0,0,0,1
the swan river,0,1,0,0,0,0,1
kracken,0,1,0,0,0,0,1
perth,0,1,0,0,0,0,1
expository,0,1,0,0,0,0,1
nacer,0,1,0,0,0,0,1
mia,1,0,0,0,0,0,1
klee,0,1,0,0,0,0,1
tunisian,0,1,0,0,0,0,1
khemir,0,1,0,0,0,0,1
winnfield,1,0,0,0,0,0,1
pommel,1,0,0,0,0,0,1
periya,0,1,0,0,0,0,1
groin,1,0,0,0,0,0,1
commute,0,1,0,0,0,0,1
sri chinmoy,0,1,0,0,0,0,1
strongest,0,1,0,0,0,0,1
restriction,0,1,0,0,0,0,1
challenging impossibility,0,1,0,0,0,0,1
limitation,0,1,0,0,0,0,1
challenging,0,1,0,0,0,0,1
contribution,0,1,0,0,0,0,1
polis,0,1,0,0,0,0,1
press.html,0,1,0,0,0,0,1
cheese,1,0,0,0,0,0,1
malkovich,0,1,0,0,0,0,1
harrison,0,1,0,0,0,0,1
world war i. butch's,1,0,0,0,0,0,1
"""http://www.polisisthis.com",0,1,0,0,0,0,1
lives.{{citation,0,1,0,0,0,0,1
ferrini,0,1,0,0,0,0,1
"strongmen,{{disambiguation",0,1,0,0,0,0,1
olympic gold-medalist,0,1,0,0,0,0,1
contemplates,0,1,0,0,0,0,1
girard,0,1,0,0,0,0,1
esaki,0,1,0,0,0,0,1
the house of,1,0,0,0,0,0,1
saktivelu,0,1,0,0,0,0,1
backlash,0,1,0,0,0,0,1
escalation,0,1,0,0,0,0,1
loggerhead,0,1,0,0,0,0,1
awkwardness,0,1,0,0,0,0,1
mainroad,0,1,0,0,0,0,1
zane,0,1,0,0,0,0,1
rectum,1,0,0,0,0,0,1
pope,0,1,0,0,0,0,1
olympia,0,1,0,0,0,0,1
stops”.{{cite,0,1,0,0,0,0,1
appearances,0,1,0,0,0,0,1
chinmoy,0,1,0,0,0,0,1
devadasis,0,1,0,0,0,0,1
gejjepooje,0,1,0,0,0,0,1
jihadist,0,1,0,0,0,0,1
pallavas,0,1,0,0,0,0,1
kshatriya,0,1,0,0,0,0,1
following,0,1,0,0,0,0,1
jetti,0,1,0,0,0,0,1
thrashing,0,1,0,0,0,0,1
premavati,0,1,0,0,0,0,1
antecedent,0,1,0,0,0,0,1
banavasi,0,1,0,0,0,0,1
mayura,0,1,0,0,0,0,1
chandravarma,0,1,0,0,0,0,1
sivaskandhavarma,0,1,0,0,0,0,1
pallava,0,1,0,0,0,0,1
vishnugopa,0,1,0,0,0,0,1
raja chandravarma,0,1,0,0,0,0,1
nilakanthagupta,0,1,0,0,0,0,1
wayside,0,1,0,0,0,0,1
srishaila,0,1,0,0,0,0,1
kadamba,0,1,0,0,0,0,1
inlaws,0,1,0,0,0,0,1
ranga,0,1,0,0,0,0,1
renaissance,0,1,0,0,0,0,1
planetarium,0,1,0,0,0,0,1
copernican,0,1,0,0,0,0,1
stardust,0,1,0,0,0,0,1
the andromeda galaxy,0,1,0,0,0,0,1
pharos,0,1,0,0,0,0,1
andromeda,0,1,0,0,0,0,1
galilei,0,1,0,0,0,0,1
alexandria,0,1,0,0,0,0,1
presenter,0,1,0,0,0,0,1
prancing,1,0,0,0,0,0,1
representation,0,1,0,0,0,0,1
kanchi,0,1,0,0,0,0,1
vedas,0,1,0,0,0,0,1
yoke,0,1,0,0,0,0,1
outlaws,0,1,0,0,0,0,1
inlaws & outlaws,0,1,0,0,0,0,1
stereotypes,0,1,0,0,0,0,1
knights,0,1,0,0,0,0,1
ratterman,0,1,0,0,0,0,1
ricardo,0,1,0,0,0,0,1
utopia,0,1,0,0,0,0,1
cuban,0,1,0,0,0,0,1
castro,0,1,0,0,0,0,1
martí,0,1,0,0,0,0,1
rebelde,0,1,0,0,0,0,1
guevara,0,1,0,0,0,0,1
televisión,0,1,0,0,0,0,1
fidel,0,1,0,0,0,0,1
che,0,1,0,0,0,0,1
radio rebelde,0,1,0,0,0,0,1
non-muslim,0,1,0,0,0,0,1
judeo-christian,0,1,0,0,0,0,1
islam,0,1,0,0,0,0,1
albania,0,1,0,0,0,0,1
landmines,0,1,0,0,0,0,1
single,0,1,0,0,0,0,1
knightsbridge,0,1,0,0,0,0,1
candor,0,1,0,0,0,0,1
thailand,0,1,0,0,0,0,1
knightsbridge international,0,1,0,0,0,0,1
gwaihir,1,0,0,0,0,0,1
rwanda,0,1,0,0,0,0,1
walt,0,1,0,0,0,0,1
burma,0,1,0,0,0,0,1
bree,1,0,0,0,0,0,1
haiti,0,1,0,0,0,0,1
artis,0,1,0,0,0,0,1
philippines,0,1,0,0,0,0,1
chechnya,0,1,0,0,0,0,1
indiana jones,0,1,0,0,0,0,1
knights of malta,0,1,0,0,0,0,1
malta,0,1,0,0,0,0,1
dalai,0,1,0,0,0,0,1
the wizard gandalf the grey warns frodo,1,0,0,0,0,0,1
yak,0,1,0,0,0,0,1
ichi,1,0,0,0,0,0,1
elderly,1,0,0,0,0,0,1
ravine,1,0,0,0,0,0,1
mahendra,1,0,0,0,0,0,1
seduction,1,0,0,0,0,0,1
tether,1,0,0,0,0,0,1
intrigue,1,0,0,0,0,0,1
isaburo,1,0,0,0,0,0,1
varman,1,0,0,0,0,0,1
20th,1,0,0,0,0,0,1
tatewaki,1,0,0,0,0,0,1
yogoro,1,0,0,0,0,0,1
tatami,1,0,0,0,0,0,1
insubordination,1,0,0,0,0,0,1
aisu,1,0,0,0,0,0,1
asano,1,0,0,0,0,0,1
vyjayanti,1,0,0,0,0,0,1
muntz,1,0,0,0,0,0,1
priyanka,1,0,0,0,0,0,1
ashish,1,0,0,0,0,0,1
khanna,1,0,0,0,0,0,1
quits,1,0,0,0,0,0,1
lester,1,0,0,0,0,0,1
tomboy,1,0,0,0,0,0,1
"the ""wilderness explorers",1,0,0,0,0,0,1
feather,1,0,0,0,0,0,1
the bubba gump shrimp company,1,0,0,0,0,0,1
helium,1,0,0,0,0,0,1
scrapbook,1,0,0,0,0,0,1
paradise falls,1,0,0,0,0,0,1
reinvigorated,1,0,0,0,0,0,1
soda,1,0,0,0,0,0,1
fredricksen,1,0,0,0,0,0,1
zookeeper,1,0,0,0,0,0,1
flightless,1,0,0,0,0,0,1
explorers,1,0,0,0,0,0,1
tomi,1,0,0,0,0,0,1
trepidation,1,0,0,0,0,0,1
vassal,1,0,0,0,0,0,1
gondorff,1,0,0,0,0,0,1
harmon,1,0,0,0,0,0,1
lonnegan,1,0,0,0,0,0,1
windfall,1,0,0,0,0,0,1
gundamma,1,0,0,0,0,0,1
loretta,1,0,0,0,0,0,1
gundamma and saroja,1,0,0,0,0,0,1
anji marries,1,0,0,0,0,0,1
polk,1,0,0,0,0,0,1
leather,1,0,0,0,0,0,1
grifter,1,0,0,0,0,0,1
shaw,1,0,0,0,0,0,1
trifecta,1,0,0,0,0,0,1
the chicago western union,1,0,0,0,0,0,1
century limited,1,0,0,0,0,0,1
hickey,1,0,0,0,0,0,1
snyder,1,0,0,0,0,0,1
kanji,1,0,0,0,0,0,1
sasahara,1,0,0,0,0,0,1
inertia,1,0,0,0,0,0,1
king rajendra varman,1,0,0,0,0,0,1
enthusiasm,1,0,0,0,0,0,1
mrinalini,1,0,0,0,0,0,1
cesspool,1,0,0,0,0,0,1
kannika,1,0,0,0,0,0,1
carefree,1,0,0,0,0,0,1
watanabe,1,0,0,0,0,0,1
suryakantham,1,0,0,0,0,0,1
playground,1,0,0,0,0,0,1
pension,1,0,0,0,0,0,1
nightlife,1,0,0,0,0,0,1
gantaiah,1,0,0,0,0,0,1
uta,1,0,0,0,0,0,1
anji,1,0,0,0,0,0,1
bureaucrat,1,0,0,0,0,0,1
cheerleader,1,0,0,0,0,0,1
carolyn,1,0,0,0,0,0,1
disciplinarian,1,0,0,0,0,0,1
cherrito,1,0,0,0,0,0,1
schoolhouse,1,0,0,0,0,0,1
cheritto,1,0,0,0,0,0,1
switchblade,1,0,0,0,0,0,1
noodles,1,0,0,0,0,0,1
forsythe,1,0,0,0,0,0,1
goldberg,1,0,0,0,0,0,1
hurricane carmen,1,0,0,0,0,0,1
auger,1,0,0,0,0,0,1
long island,1,0,0,0,0,0,1
relaxation,1,0,0,0,0,0,1
manoldi,1,0,0,0,0,0,1
hoard,1,0,0,0,0,0,1
plot|date1920smcobaaaambaj&pgen&source2,1,0,0,0,0,0,1
asshole,1,0,0,0,0,0,1
cleopatra,1,0,0,0,0,0,1
surveil,1,0,0,0,0,0,1
drucker,1,0,0,0,0,0,1
amputee,1,0,0,0,0,0,1
hanna,1,0,0,0,0,0,1
stepdaughter,1,0,0,0,0,0,1
breeden,1,0,0,0,0,0,1
lax,1,0,0,0,0,0,1
counterculture,1,0,0,0,0,0,1
detective cassals,1,0,0,0,0,0,1
snitch,1,0,0,0,0,0,1
bosko,1,0,0,0,0,0,1
cassals,1,0,0,0,0,0,1
watergate,1,0,0,0,0,0,1
forrest,1,0,0,0,0,0,1
cripple,1,0,0,0,0,0,1
launderer,1,0,0,0,0,0,1
hippie,1,0,0,0,0,0,1
eady,1,0,0,0,0,0,1
los angeles international airport,1,0,0,0,0,0,1
dominic,1,0,0,0,0,0,1
pong,1,0,0,0,0,0,1
burnhams,1,0,0,0,0,0,1
new york magazine,1,0,0,0,0,0,1
the new york federal reserve bank,1,0,0,0,0,0,1
yours,1,0,0,0,0,0,1
patsy,1,0,0,0,0,0,1
bugsy,1,0,0,0,0,0,1
dockyard,1,0,0,0,0,0,1
syndicate,1,0,0,0,0,0,1
radius,1,0,0,0,0,0,1
deborah,1,0,0,0,0,0,1
physique,1,0,0,0,0,0,1
surroundings,1,0,0,0,0,0,1
camcorder,1,0,0,0,0,0,1
hayes,1,0,0,0,0,0,1
fitts,1,0,0,0,0,0,1
united states marine corps,1,0,0,0,0,0,1
marry,1,0,0,0,0,0,1
pp.16,1,0,0,0,0,0,1
cockeye,1,0,0,0,0,0,1
detroit,1,0,0,0,0,0,1
o'donnell,1,0,0,0,0,0,1
fat moe's,1,0,0,0,0,0,1
shrimping,1,0,0,0,0,0,1
fat,1,0,0,0,0,0,1
prohibition,1,0,0,0,0,0,1
gelly,1,0,0,0,0,0,1
frankie,1,0,0,0,0,0,1
fat moe,1,0,0,0,0,0,1
the bailey foundation,1,0,0,0,0,0,1
the west coast,1,0,0,0,0,0,1
antony,1,0,0,0,0,0,1
bercovicz,1,0,0,0,0,0,1
realisation,1,0,0,0,0,0,1
speakeasy,1,0,0,0,0,0,1
auspex,1,0,0,0,0,0,1
the university of alabama,1,0,0,0,0,0,1
limited,1,0,0,0,0,0,1
sting,1,0,0,0,0,0,1
padum,0,1,0,0,0,0,1
"manab , nayan",0,1,0,0,0,0,1
comeau,0,1,0,0,0,0,1
acadian,0,1,0,0,0,0,1
dunn,0,1,0,0,0,0,1
marla,1,0,0,0,0,0,1
tinsukia,0,1,0,0,0,0,1
divisional,0,1,0,0,0,0,1
guwahati,0,1,0,0,0,0,1
akan,0,1,0,0,0,0,1
luther,1,0,0,0,0,0,1
amateur,0,1,0,0,0,0,1
assam civil service,0,1,0,0,0,0,1
furore,0,1,0,0,0,0,1
tapan,0,1,0,0,0,0,1
assam,0,1,0,0,0,0,1
manab,0,1,0,0,0,0,1
engage,1,0,0,0,0,0,1
brunswick,0,1,0,0,0,0,1
forestry,0,1,0,0,0,0,1
woodlot,0,1,0,0,0,0,1
wishart,0,1,0,0,0,0,1
ramabhadraiah,1,0,0,0,0,0,1
jousting,1,0,0,0,0,0,1
pierrots,1,0,0,0,0,0,1
françois,1,0,0,0,0,0,1
singerman,1,0,0,0,0,0,1
garance with lacenaire,1,0,0,0,0,0,1
jéricho,1,0,0,0,0,0,1
debts&nbsp,1,0,0,0,0,0,1
garance,1,0,0,0,0,0,1
consumerism,1,0,0,0,0,0,1
durden,1,0,0,0,0,0,1
sparky,0,1,0,0,0,0,1
hockenberry,0,1,0,0,0,0,1
holly,0,1,0,0,0,0,1
flavoring,0,1,0,0,0,0,1
tyler,1,0,0,0,0,0,1
pang,0,1,0,0,0,0,1
nayan,0,1,0,0,0,0,1
angad,0,1,0,0,0,0,1
http://gadadharputy.blogspot.com/,0,1,0,0,0,0,1
spoilt,0,1,0,0,0,0,1
pooja,0,1,0,0,0,0,1
brickyard,0,1,0,0,0,0,1
project mayhem,1,0,0,0,0,0,1
honcho,0,1,0,0,0,0,1
uday,0,1,0,0,0,0,1
nepalese,0,1,0,0,0,0,1
boromir,1,0,0,0,0,0,1
leh,0,1,0,0,0,0,1
galadriel informs frodo,1,0,0,0,0,0,1
ladakh,0,1,0,0,0,0,1
bhutan,0,1,0,0,0,0,1
"bree, frodo",1,0,0,0,0,0,1
lurtz,1,0,0,0,0,0,1
pooja to pooja,0,1,0,0,0,0,1
biswas,0,1,0,0,0,0,1
biopic,0,1,0,0,0,0,1
sikh,0,1,0,0,0,0,1
maharashtra,0,1,0,0,0,0,1
savitribai,0,1,0,0,0,0,1
peth,0,1,0,0,0,0,1
phule,0,1,0,0,0,0,1
upliftment,0,1,0,0,0,0,1
budhwar,0,1,0,0,0,0,1
"maharashtra, india",0,1,0,0,0,0,1
reformer,0,1,0,0,0,0,1
phule.,0,1,0,0,0,0,1
main,0,1,0,0,0,0,1
preet,0,1,0,0,0,0,1
kaya,0,1,0,0,0,0,1
bedi,0,1,0,0,0,0,1
meerut,0,1,0,0,0,0,1
taran,0,1,0,0,0,0,1
perform,1,0,0,0,0,0,1
the funambules theater.,1,0,0,0,0,0,1
drunk,1,0,0,0,0,0,1
prabhjot,1,0,0,0,0,0,1
kanchu,1,0,0,0,0,0,1
anjaneya prasad a.k.a,1,0,0,0,0,0,1
stepan,1,0,0,0,0,0,1
veronika,1,0,0,0,0,0,1
fyodor ivanovich's,1,0,0,0,0,0,1
fervor,1,0,0,0,0,0,1
conscription,1,0,0,0,0,0,1
blitzkrieg,1,0,0,0,0,0,1
http://www.imdb.com/title/tt0262455/,1,0,0,0,0,0,1
deferral,1,0,0,0,0,0,1
irina,1,0,0,0,0,0,1
context,1,0,0,0,0,0,1
fyodor ivanovich,1,0,0,0,0,0,1
ivanovich,1,0,0,0,0,0,1
subway,1,0,0,0,0,0,1
disapproves,1,0,0,0,0,0,1
zindabad,1,0,0,0,0,0,1
othello,1,0,0,0,0,0,1
prabjyot,1,0,0,0,0,0,1
prabhakar,1,0,0,0,0,0,1
salino,1,0,0,0,0,0,1
erie,1,0,0,0,0,0,1
span,1,0,0,0,0,0,1
dada,1,0,0,0,0,0,1
grand daughter,1,0,0,0,0,0,1
kaur,1,0,0,0,0,0,1
devinder,1,0,0,0,0,0,1
prabhjyot,1,0,0,0,0,0,1
gurkirtan,1,0,0,0,0,0,1
chandigarh,1,0,0,0,0,0,1
chandigarh city,1,0,0,0,0,0,1
joginder,1,0,0,0,0,0,1
ji,1,0,0,0,0,0,1
jawani,1,0,0,0,0,0,1
world war,1,0,0,0,0,0,1
boulevard,1,0,0,0,0,0,1
rouge,1,0,0,0,0,0,1
pierrot,1,0,0,0,0,0,1
baptiste,1,0,0,0,0,0,1
scaffold,1,0,0,0,0,0,1
frédérick,1,0,0,0,0,0,1
l'homme,1,0,0,0,0,0,1
the count de montray,1,0,0,0,0,0,1
gundamma for lakshmi's,1,0,0,0,0,0,1
peddler,1,0,0,0,0,0,1
cuckold,1,0,0,0,0,0,1
debureau,1,0,0,0,0,0,1
dancehall,1,0,0,0,0,0,1
vocation,1,0,0,0,0,0,1
funambules,1,0,0,0,0,0,1
édouard,1,0,0,0,0,0,1
durgamma,1,0,0,0,0,0,1
unheeding,1,0,0,0,0,0,1
avarice,1,0,0,0,0,0,1
haranath,1,0,0,0,0,0,1
the great post house,1,0,0,0,0,0,1
epoch,1,0,0,0,0,0,1
nathalie,1,0,0,0,0,0,1
lacenaire,1,0,0,0,0,0,1
delinquent,1,0,0,0,0,0,1
mime,1,0,0,0,0,0,1
pantomime,1,0,0,0,0,0,1
avril,1,0,0,0,0,0,1
the grand theater,1,0,0,0,0,0,1
lemaître,1,0,0,0,0,0,1
montray,1,0,0,0,0,0,1
incognito,1,0,0,0,0,0,1
conceit,1,0,0,0,0,0,1
proposition,1,0,0,0,0,0,1
scrivener,1,0,0,0,0,0,1
pierre-françois lacenaire,1,0,0,0,0,0,1
dandy,1,0,0,0,0,0,1
marsellus,1,0,0,0,0,0,1
krstić & son,0,1,0,0,0,0,1
bear bryant,1,0,0,0,0,0,1
dragoons,1,0,0,0,0,0,1
likeness,0,1,0,0,0,0,1
philanderer,0,1,0,0,0,0,1
sriranjani,0,1,0,0,0,0,1
mohanasundaram,0,1,0,0,0,0,1
balu,0,1,0,0,0,0,1
kantha,0,1,0,0,0,0,1
improvised explosive device,1,0,0,0,0,0,1
burrow,0,1,0,0,0,0,1
brent,0,1,0,0,0,0,1
fidelity,0,1,0,0,0,0,1
appanna,0,1,0,0,0,0,1
malky,0,1,0,0,0,0,1
doorman,0,1,0,0,0,0,1
originality,0,1,0,0,0,0,1
afghan diaries,1,0,0,0,0,0,1
improvised,1,0,0,0,0,0,1
formality,0,1,0,0,0,0,1
viewers,1,0,0,0,0,0,1
the good soldier,0,1,0,0,0,0,1
ied.the,1,0,0,0,0,0,1
shenon,0,1,0,0,0,0,1
schwarzenegger,0,1,0,0,0,0,1
the university of denver,0,1,0,0,0,0,1
stanford university,0,1,0,0,0,0,1
qaeda,0,1,0,0,0,0,1
mccain,0,1,0,0,0,0,1
kissinger,0,1,0,0,0,0,1
diaries,1,0,0,0,0,0,1
interviewee,0,1,0,0,0,0,1
birmingham,0,1,0,0,0,0,1
flanders,0,1,0,0,0,0,1
the royal flush film festival,0,1,0,0,0,0,1
mills,0,1,0,0,0,0,1
ogden,0,1,0,0,0,0,1
juxtaposition,0,1,0,0,0,0,1
third world war,0,1,0,0,0,0,1
a 'time machine',0,1,0,0,0,0,1
regionalism,0,1,0,0,0,0,1
maruthu,0,1,0,0,0,0,1
pandiyars,0,1,0,0,0,0,1
marudhu,0,1,0,0,0,0,1
oomadurai,0,1,0,0,0,0,1
kayattar,0,1,0,0,0,0,1
kattabomman,0,1,0,0,0,0,1
sivaganga,0,1,0,0,0,0,1
handlers,0,1,0,0,0,0,1
american tourists,0,1,0,0,0,0,1
enlightenment,0,1,0,0,0,0,1
tourists,0,1,0,0,0,0,1
tantra,0,1,0,0,0,0,1
spinal,0,1,0,0,0,0,1
petawawa,1,0,0,0,0,0,1
bullock,0,1,0,0,0,0,1
shampa,0,1,0,0,0,0,1
the maruthu pandiyars',0,1,0,0,0,0,1
accessdate17277,0,1,0,0,0,0,1
ramdas,0,1,0,0,0,0,1
the free aceh movement,0,1,0,0,0,0,1
hema,0,1,0,0,0,0,1
treat,0,1,0,0,0,0,1
the 'time machine',0,1,0,0,0,0,1
aceh,0,1,0,0,0,0,1
the black road,0,1,0,0,0,0,1
reporters,0,1,0,0,0,0,1
nessen,0,1,0,0,0,0,1
name7417 reporters,0,1,0,0,0,0,1
frontières,0,1,0,0,0,0,1
urlbbc,0,1,0,0,0,0,1
title3,0,1,0,0,0,0,1
national post: movie,1,0,0,0,0,0,1
marhaban,0,1,0,0,0,0,1
forces.<ref,0,1,0,0,0,0,1
indonesian,0,1,0,0,0,0,1
negligence,0,1,0,0,0,0,1
ieds,1,0,0,0,0,0,1
a world war,0,1,0,0,0,0,1
ávh,0,1,0,0,0,0,1
dyke,0,1,0,0,0,0,1
ww2,0,1,0,0,0,0,1
dániel,0,1,0,0,0,0,1
pelikán,0,1,0,0,0,0,1
amsterdam,1,0,0,0,0,0,1
virág,0,1,0,0,0,0,1
the underground communist movement,0,1,0,0,0,0,1
józsef,0,1,0,0,0,0,1
chevron,0,1,0,0,0,0,1
zoltán dániel,0,1,0,0,0,0,1
zoltán,0,1,0,0,0,0,1
dodderi,0,1,0,0,0,0,1
venkatagiri,0,1,0,0,0,0,1
avadhaana,0,1,0,0,0,0,1
ganges,0,1,0,0,0,0,1
lurch,0,1,0,0,0,0,1
reprisal,0,1,0,0,0,0,1
dysentery,1,0,0,0,0,0,1
jananaki,0,1,0,0,0,0,1
nandhini,0,1,0,0,0,0,1
malcolm,0,1,0,0,0,0,1
fabienne,1,0,0,0,0,0,1
anju aravind's,0,1,0,0,0,0,1
nandhini anju aravind,0,1,0,0,0,0,1
hostel,0,1,0,0,0,0,1
velingiri,0,1,0,0,0,0,1
the loud & frightful velingiri,0,1,0,0,0,0,1
marrying,0,1,0,0,0,0,1
wildfire,0,1,0,0,0,0,1
janaki,0,1,0,0,0,0,1
gopi,0,1,0,0,0,0,1
dmy,0,1,0,0,0,0,1
jaiganesh,0,1,0,0,0,0,1
figment,0,1,0,0,0,0,1
frightful,0,1,0,0,0,0,1
bargain,0,1,0,0,0,0,1
lecture,0,1,0,0,0,0,1
professionalism,0,1,0,0,0,0,1
laura,0,1,0,0,0,0,1
presidents,0,1,0,0,0,0,1
provost,0,1,0,0,0,0,1
scowcroft,0,1,0,0,0,0,1
cheney,0,1,0,0,0,0,1
stalin,0,1,0,0,0,0,1
winfrey,0,1,0,0,0,0,1
upchurch,0,1,0,0,0,0,1
w.,0,1,0,0,0,0,1
joint media group inc.,1,0,0,0,0,0,1
national security advisor,0,1,0,0,0,0,1
stanford university provost,0,1,0,0,0,0,1
arnold,0,1,0,0,0,0,1
oprah,0,1,0,0,0,0,1
clarke,0,1,0,0,0,0,1
al qaeda,0,1,0,0,0,0,1
stanford,0,1,0,0,0,0,1
puerto rico,0,1,0,0,0,0,1
prizefighter,1,0,0,0,0,0,1
rico,0,1,0,0,0,0,1
academician,0,1,0,0,0,0,1
royal canadian dragoons,1,0,0,0,0,0,1
dandelion,0,1,0,0,0,0,1
go,0,1,0,0,0,0,1
pegasus,0,1,0,0,0,0,1
journeys,0,1,0,0,0,0,1
kite,0,1,0,0,0,0,1
olmec,0,1,0,0,0,0,1
the royal canadian dragoons,1,0,0,0,0,0,1
hoop,0,1,0,0,0,0,1
esprit de corps,1,0,0,0,0,0,1
meadow,0,1,0,0,0,0,1
puerto,0,1,0,0,0,0,1
denise,0,1,0,0,0,0,1
adan,0,1,0,0,0,0,1
cholera,0,1,0,0,0,0,1
p65,0,1,0,0,0,0,1
anil,0,1,0,0,0,0,1
springboard,0,1,0,0,0,0,1
smokey,0,1,0,0,0,0,1
dorsey,0,1,0,0,0,0,1
the smokey mountains,0,1,0,0,0,0,1
ied.the toronto sun,1,0,0,0,0,0,1
m.d.,1,0,0,0,0,0,1
sheeting,0,1,0,0,0,0,1
marc,1,0,0,0,0,0,1
carpeting,0,1,0,0,0,0,1
choma,0,1,0,0,0,0,1
diab,1,0,0,0,0,0,1
kaitheri,0,1,0,0,0,0,1
intensifies,0,1,0,0,0,0,1
sankara,0,1,0,0,0,0,1
ambu,0,1,0,0,0,0,1
unni,0,1,0,0,0,0,1
inform,0,1,0,0,0,0,1
hairkutt,0,1,0,0,0,0,1
ontario,1,0,0,0,0,0,1
st. louis,0,1,0,0,0,0,1
porto,0,1,0,0,0,0,1
urvasi,0,1,0,0,0,0,1
swathi,0,1,0,0,0,0,1
mansur,0,1,0,0,0,0,1
diabs,1,0,0,0,0,0,1
anete,0,1,0,0,0,0,1
suzuki,0,1,0,0,0,0,1
tomato,0,1,0,0,0,0,1
alegre,0,1,0,0,0,0,1
flowers,0,1,0,0,0,0,1
isle,0,1,0,0,0,0,1
saleswoman,0,1,0,0,0,0,1
perfume,0,1,0,0,0,0,1
sauce,0,1,0,0,0,0,1
isle of flowers,0,1,0,0,0,0,1
d squadron,1,0,0,0,0,0,1
chanthu,0,1,0,0,0,0,1
thampuratty,0,1,0,0,0,0,1
thampuratti,0,1,0,0,0,0,1
esprit,1,0,0,0,0,0,1
coptic,0,1,0,0,0,0,1
moqattam,0,1,0,0,0,0,1
coptic christians,0,1,0,0,0,0,1
spirituality,0,1,0,0,0,0,1
upper,0,1,0,0,0,0,1
pyramids,0,1,0,0,0,0,1
rotting,0,1,0,0,0,0,1
pigeon,0,1,0,0,0,0,1
zabbaleen,0,1,0,0,0,0,1
recyclers,0,1,0,0,0,0,1
slant magazine,0,1,0,0,0,0,1
slant,0,1,0,0,0,0,1
coptic christian,0,1,0,0,0,0,1
climbing,0,1,0,0,0,0,1
keowa,0,1,0,0,0,0,1
marina,0,1,0,0,0,0,1
moosa,0,1,0,0,0,0,1
veedan,0,1,0,0,0,0,1
east india company,0,1,0,0,0,0,1
pazhassi,0,1,0,0,0,0,1
puralimala,0,1,0,0,0,0,1
wellesley,0,1,0,0,0,0,1
kurumbranad,0,1,0,0,0,0,1
kurichya,0,1,0,0,0,0,1
bowman,0,1,0,0,0,0,1
wiss,1,0,0,0,0,0,1
kottayam,0,1,0,0,0,0,1
manage,0,1,0,0,0,0,1
tipu,0,1,0,0,0,0,1
maakkam,0,1,0,0,0,0,1
baber,0,1,0,0,0,0,1
tipu sultan,0,1,0,0,0,0,1
kannavathu,0,1,0,0,0,0,1
pazhayam,0,1,0,0,0,0,1
balakrishan,0,1,0,0,0,0,1
ramji rav,0,1,0,0,0,0,1
culliton,1,0,0,0,0,0,1
youtube,1,0,0,0,0,0,1
tobacco,0,1,0,0,0,0,1
shridhar,0,1,0,0,0,0,1
dhibet,0,1,0,0,0,0,1
gharsallah,0,1,0,0,0,0,1
madman,0,1,0,0,0,0,1
cusp,0,1,0,0,0,0,1
beresford,0,1,0,0,0,0,1
spook,0,1,0,0,0,0,1
stowfield,0,1,0,0,0,0,1
darkest,0,1,0,0,0,0,1
glowing,0,1,0,0,0,0,1
the second gulf war,0,1,0,0,0,0,1
giovanni,0,1,0,0,0,0,1
colvin,0,1,0,0,0,0,1
ghraib,0,1,0,0,0,0,1
maharashtrian,0,1,0,0,0,0,1
molestation,0,1,0,0,0,0,1
camerawoman,0,1,0,0,0,0,1
moral,0,1,0,0,0,0,1
missionary,0,1,0,0,0,0,1
banerjee,0,1,0,0,0,0,1
manvela,0,1,0,0,0,0,1
belli,0,1,0,0,0,0,1
lure,0,1,0,0,0,0,1
christianity,0,1,0,0,0,0,1
gurufji,0,1,0,0,0,0,1
guriji,0,1,0,0,0,0,1
pinjra,0,1,0,0,0,0,1
tamasha,0,1,0,0,0,0,1
blaue,0,1,0,0,0,0,1
engel,0,1,0,0,0,0,1
mastar,0,1,0,0,0,0,1
chandrakala,0,1,0,0,0,0,1
bajirao,0,1,0,0,0,0,1
bingham,0,1,0,0,0,0,1
janine,0,1,0,0,0,0,1
candidate,0,1,0,0,0,0,1
thamapan,0,1,0,0,0,0,1
ramji,0,1,0,0,0,0,1
urummes,0,1,0,0,0,0,1
understand,1,0,0,0,0,0,1
goplakrishnan,0,1,0,0,0,0,1
vijayaraghavan,0,1,0,0,0,0,1
cochin,0,1,0,0,0,0,1
lodging,0,1,0,0,0,0,1
urumees,0,1,0,0,0,0,1
theaters,0,1,0,0,0,0,1
urvasi theaters,0,1,0,0,0,0,1
panicking,0,1,0,0,0,0,1
thampan,0,1,0,0,0,0,1
justifies,0,1,0,0,0,0,1
devan,0,1,0,0,0,0,1
urvasai,0,1,0,0,0,0,1
mathayi,0,1,0,0,0,0,1
gopalakrishnan,0,1,0,0,0,0,1
council bluffs,0,1,0,0,0,0,1
urumees thamapan,0,1,0,0,0,0,1
bagby,0,1,0,0,0,0,1
bluffs,0,1,0,0,0,0,1
wounds.{{cite,0,1,0,0,0,0,1
lebanese,1,0,0,0,0,0,1
latrobe,0,1,0,0,0,0,1
canadian american,0,1,0,0,0,0,1
ont,1,0,0,0,0,0,1
shirley,0,1,0,0,0,0,1
passer,0,1,0,0,0,0,1
dosti,0,1,0,0,0,0,1
ramnath,0,1,0,0,0,0,1
gupta,0,1,0,0,0,0,1
mannar,0,1,0,0,0,0,1
rav,0,1,0,0,0,0,1
earning,0,1,0,0,0,0,1
face.{{cite,0,1,0,0,0,0,1
fa,0,1,0,0,0,0,1
the catskill mountains,0,1,0,0,0,0,1
dios,0,1,0,0,0,0,1
kanthamma,0,1,0,0,0,0,1
siblings,0,1,0,0,0,0,1
separation,0,1,0,0,0,0,1
deepavali,0,1,0,0,0,0,1
expressionless,0,1,0,0,0,0,1
negotiator,0,1,0,0,0,0,1
gimp,1,0,0,0,0,0,1
jimmie,1,0,0,0,0,0,1
doraemon,0,1,0,0,0,0,1
alberto,0,1,0,0,0,0,1
noche,0,1,0,0,0,0,1
cría,0,1,0,0,0,0,1
banter,1,0,0,0,0,0,1
redondo,0,1,0,0,0,0,1
gran,0,1,0,0,0,0,1
compliment,0,1,0,0,0,0,1
embargo,0,1,0,0,0,0,1
abbas,0,1,0,0,0,0,1
ravage,0,1,0,0,0,0,1
babylon,0,1,0,0,0,0,1
valerie,0,1,0,0,0,0,1
alternative,0,1,0,0,0,0,1
formation,0,1,0,0,0,0,1
potrero,0,1,0,0,0,0,1
housing,0,1,0,0,0,0,1
skytower,0,1,0,0,0,0,1
neca,0,1,0,0,0,0,1
distribution,0,1,0,0,0,0,1
arguing,0,1,0,0,0,0,1
delgado,0,1,0,0,0,0,1
after,0,1,0,0,0,0,1
fahdel,0,1,0,0,0,0,1
fix,1,0,0,0,0,0,1
the united nations,0,1,0,0,0,0,1
slim,1,0,0,0,0,0,1
indiscretion,0,1,0,0,0,0,1
massage,1,0,0,0,0,0,1
excommunion,0,1,0,0,0,0,1
palegar,0,1,0,0,0,0,1
jayadeva,0,1,0,0,0,0,1
valour,0,1,0,0,0,0,1
chitradurga,0,1,0,0,0,0,1
basayya,0,1,0,0,0,0,1
royale,1,0,0,0,0,0,1
jaya,0,1,0,0,0,0,1
noor jahan's,0,1,0,0,0,0,1
noor,0,1,0,0,0,0,1
nayaka,0,1,0,0,0,0,1
jahan,0,1,0,0,0,0,1
noor jahan,0,1,0,0,0,0,1
hyder,0,1,0,0,0,0,1
rathna,0,1,0,0,0,0,1
tact,0,1,0,0,0,0,1
shizuka,0,1,0,0,0,0,1
madakari,0,1,0,0,0,0,1
surety,0,1,0,0,0,0,1
annette,0,1,0,0,0,0,1
cremates,0,1,0,0,0,0,1
negocio,0,1,0,0,0,0,1
fernando,0,1,0,0,0,0,1
entre,0,1,0,0,0,0,1
una,0,1,0,0,0,0,1
snapping,0,1,0,0,0,0,1
marcos,0,1,0,0,0,0,1
bordello,0,1,0,0,0,0,1
otra,0,1,0,0,0,0,1
josefina,0,1,0,0,0,0,1
doce,0,1,0,0,0,0,1
bhootayya,0,1,0,0,0,0,1
ayyu,0,1,0,0,0,0,1
gulla,0,1,0,0,0,0,1
merciless,0,1,0,0,0,0,1
swimmer,0,1,0,0,0,0,1
enterprise.http://www.campcampaign.com/could-the-40-point-plan-work-in-the-real-world/,0,1,0,0,0,0,1
implementation,0,1,0,0,0,0,1
national employment corporation of america,0,1,0,0,0,0,1
santosh,0,1,0,0,0,0,1
satyabhama,0,1,0,0,0,0,1
manja,0,1,0,0,0,0,1
nanjappan,0,1,0,0,0,0,1
sangeetha,0,1,0,0,0,0,1
honey,1,0,0,0,0,0,1
muttiah,0,1,0,0,0,0,1
maga,0,1,0,0,0,0,1
subbalakshmi,0,1,0,0,0,0,1
stores,0,1,0,0,0,0,1
nanja,0,1,0,0,0,0,1
oorubaglu general stores',0,1,0,0,0,0,1
muttiah bank,0,1,0,0,0,0,1
ganesh and sandhya,0,1,0,0,0,0,1
sandhya,0,1,0,0,0,0,1
ravi,0,1,0,0,0,0,1
janardhan,0,1,0,0,0,0,1
seena,0,1,0,0,0,0,1
manthra,0,1,0,0,0,0,1
sundari,0,1,0,0,0,0,1
the kingdom of yugoslavia,0,1,0,0,0,0,1
krstić sr.,0,1,0,0,0,0,1
miško,0,1,0,0,0,0,1
cutaway,1,0,0,0,0,0,1
krstić,0,1,0,0,0,0,1
germanophile,0,1,0,0,0,0,1
coolidge,1,0,0,0,0,0,1
krstić jr.'s,0,1,0,0,0,0,1
sightseeing,0,1,0,0,0,0,1
gunjappa,0,1,0,0,0,0,1
costumer,0,1,0,0,0,0,1
shastry,0,1,0,0,0,0,1
oorubaglu,0,1,0,0,0,0,1
-'chitke,0,1,0,0,0,0,1
assume,0,1,0,0,0,0,1
chadrasekhar,0,1,0,0,0,0,1
koons,1,0,0,0,0,0,1
superstores,0,1,0,0,0,0,1
hilberg,0,1,0,0,0,0,1
henryk,0,1,0,0,0,0,1
filip,0,1,0,0,0,0,1
bomba,0,1,0,0,0,0,1
vrba,0,1,0,0,0,0,1
shopowner,1,0,0,0,0,0,1
chełmno,0,1,0,0,0,0,1
franz suchomel,0,1,0,0,0,0,1
mordechaï,0,1,0,0,0,0,1
henryk gawkowski,0,1,0,0,0,0,1
lookalikes,1,0,0,0,0,0,1
jan,0,1,0,0,0,0,1
gawkowski,0,1,0,0,0,0,1
billionaire,0,1,0,0,0,0,1
rivers,0,1,0,0,0,0,1
kuthbert,0,1,0,0,0,0,1
raul,0,1,0,0,0,0,1
ambivalence,1,0,0,0,0,0,1
reverie,1,0,0,0,0,0,1
chelmno,0,1,0,0,0,0,1
fathima,0,1,0,0,0,0,1
müller,0,1,0,0,0,0,1
schalling,0,1,0,0,0,0,1
vodka,0,1,0,0,0,0,1
gassing,0,1,0,0,0,0,1
srebnik,0,1,0,0,0,0,1
grassler,0,1,0,0,0,0,1
testimonies,0,1,0,0,0,0,1
lanzmann,0,1,0,0,0,0,1
glazar,0,1,0,0,0,0,1
podchlebnik,0,1,0,0,0,0,1
birkenau,0,1,0,0,0,0,1
franz,0,1,0,0,0,0,1
karski,0,1,0,0,0,0,1
suchomel,0,1,0,0,0,0,1
nobita,0,1,0,0,0,0,1
halbfass,0,1,0,0,0,0,1
hologram,0,1,0,0,0,0,1
questions,0,1,0,0,0,0,1
gentrification,0,1,0,0,0,0,1
helping,0,1,0,0,0,0,1
streetwise,0,1,0,0,0,0,1
realist,0,1,0,0,0,0,1
oeuvre,0,1,0,0,0,0,1
wink,0,1,0,0,0,0,1
outreach,0,1,0,0,0,0,1
jasper,0,1,0,0,0,0,1
jig,0,1,0,0,0,0,1
vacuity,0,1,0,0,0,0,1
kotayya,0,1,0,0,0,0,1
raghu ramayya,0,1,0,0,0,0,1
bharati,0,1,0,0,0,0,1
ramayya,0,1,0,0,0,0,1
the lollipop generation,0,1,0,0,0,0,1
sharyn,0,1,0,0,0,0,1
intertribal,0,1,0,0,0,0,1
native-american,0,1,0,0,0,0,1
pumpkin,1,0,0,0,0,0,1
mardi,0,1,0,0,0,0,1
guesthouse,0,1,0,0,0,0,1
ramayana,0,1,0,0,0,0,1
puneet,0,1,0,0,0,0,1
kannada,0,1,0,0,0,0,1
backstreets,0,1,0,0,0,0,1
gras,0,1,0,0,0,0,1
big chiefs,0,1,0,0,0,0,1
boudreaux,0,1,0,0,0,0,1
doucette,0,1,0,0,0,0,1
katrina,0,1,0,0,0,0,1
chiefs,0,1,0,0,0,0,1
hurricane katrina,0,1,0,0,0,0,1
hatchet,0,1,0,0,0,0,1
prettiest,0,1,0,0,0,0,1
african-american,0,1,0,0,0,0,1
dec,0,1,0,0,0,0,1
liss,0,1,0,0,0,0,1
jena,0,1,0,0,0,0,1
newell,0,1,0,0,0,0,1
passing,0,1,0,0,0,0,1
cranberry park,0,1,0,0,0,0,1
overdoses,1,0,0,0,0,0,1
mister,0,1,0,0,0,0,1
cranberry,0,1,0,0,0,0,1
"family communications, inc.",0,1,0,0,0,0,1
bridgeville,0,1,0,0,0,0,1
schenley,0,1,0,0,0,0,1
intercut,0,1,0,0,0,0,1
maryland,0,1,0,0,0,0,1
http://www.fci.org/viewcontent.asp?sectionid{c4741ae9-b471-40ae-b594-e7bfe5a26c5b}&subsubsectionid={5b10796f-a045-46f3-a004-06ddcb1ae875,0,1,0,0,0,0,1
soni,0,1,0,0,0,0,1
suren,0,1,0,0,0,0,1
catskill,0,1,0,0,0,0,1
sect,0,1,0,0,0,0,1
communications,0,1,0,0,0,0,1
jamindar,0,1,0,0,0,0,1
catalogue,0,1,0,0,0,0,1
jhansi,0,1,0,0,0,0,1
cine,0,1,0,0,0,0,1
eye weekly,0,1,0,0,0,0,1
buenos,0,1,0,0,0,0,1
apr,0,1,0,0,0,0,1
buenos aires festival,0,1,0,0,0,0,1
brücker,0,1,0,0,0,0,1
internacional,0,1,0,0,0,0,1
pronouncement,1,0,0,0,0,0,1
mar-5,0,1,0,0,0,0,1
independiente,0,1,0,0,0,0,1
disentanglement,0,1,0,0,0,0,1
kumaraswami,0,1,0,0,0,0,1
vetrivel,0,1,0,0,0,0,1
kokila,0,1,0,0,0,0,1
vettivel,0,1,0,0,0,0,1
kuvempu,0,1,0,0,0,0,1
darshanam,0,1,0,0,0,0,1
deportee,0,1,0,0,0,0,1
beat,0,1,0,0,0,0,1
sultans,0,1,0,0,0,0,1
krishnasini,0,1,0,0,0,0,1
repartee,0,1,0,0,0,0,1
bahmani,0,1,0,0,0,0,1
deccan,0,1,0,0,0,0,1
omniscient,0,1,0,0,0,0,1
sensuousness,0,1,0,0,0,0,1
tenali raman,0,1,0,0,0,0,1
tenali,0,1,0,0,0,0,1
ramakrishna,0,1,0,0,0,0,1
sultnate,0,1,0,0,0,0,1
ahmednagar,0,1,0,0,0,0,1
golconda,0,1,0,0,0,0,1
the deccan sultans of berar,0,1,0,0,0,0,1
vijayanagaram,0,1,0,0,0,0,1
berar,0,1,0,0,0,0,1
hedonism,0,1,0,0,0,0,1
inaccessibility,0,1,0,0,0,0,1
narcissism,0,1,0,0,0,0,1
emil,0,1,0,0,0,0,1
blaze,0,1,0,0,0,0,1
dependency,0,1,0,0,0,0,1
slavko,0,1,0,0,0,0,1
roddy,0,1,0,0,0,0,1
muse,0,1,0,0,0,0,1
unmarino,0,1,0,0,0,0,1
trunche,0,1,0,0,0,0,1
knee,0,1,0,0,0,0,1
schiffman,0,1,0,0,0,0,1
kelley,0,1,0,0,0,0,1
elwell,0,1,0,0,0,0,1
maynard,1,0,0,0,0,0,1
academia,0,1,0,0,0,0,1
slavco,0,1,0,0,0,0,1
tenali ramakrishna,0,1,0,0,0,0,1
orders,0,1,0,0,0,0,1
skid,0,1,0,0,0,0,1
videotape,0,1,0,0,0,0,1
dating,0,1,0,0,0,0,1
mcdonald's,1,0,0,0,0,0,1
pawnshop,1,0,0,0,0,0,1
syrup,0,1,0,0,0,0,1
leonardo,0,1,0,0,0,0,1
cruising,0,1,0,0,0,0,1
dicaprio,0,1,0,0,0,0,1
sexuality,0,1,0,0,0,0,1
weekends,0,1,0,0,0,0,1
migrant,0,1,0,0,0,0,1
lily,0,1,0,0,0,0,1
strident,0,1,0,0,0,0,1
cough,0,1,0,0,0,0,1
portales,0,1,0,0,0,0,1
mcdonald,1,0,0,0,0,0,1
downturn,0,1,0,0,0,0,1
helpline,0,1,0,0,0,0,1
timmarusu,0,1,0,0,0,0,1
missing,0,1,0,0,0,0,1
thirumalamba,0,1,0,0,0,0,1
bidar,0,1,0,0,0,0,1
kanakaraj,0,1,0,0,0,0,1
bijapur,0,1,0,0,0,0,1
connoisseur,0,1,0,0,0,0,1
reports,0,1,0,0,0,0,1
reality tv,0,1,0,0,0,0,1
kerry,0,1,0,0,0,0,1
abi,0,1,0,0,0,0,1
occurs,0,1,0,0,0,0,1
breakthrough,0,1,0,0,0,0,1
samantha,0,1,0,0,0,0,1
villalobos,1,0,0,0,0,0,1
the national missing persons helpline,0,1,0,0,0,0,1
persons,0,1,0,0,0,0,1
nixon,1,0,0,0,0,0,1
zant,1,0,0,0,0,0,1
catskills,0,1,0,0,0,0,1
the middle east,1,0,0,0,0,0,1
bin,1,0,0,0,0,0,1
chilton,1,0,0,0,0,0,1
o'hare,1,0,0,0,0,0,1
sol,1,0,0,0,0,0,1
subplots,1,0,0,0,0,0,1
buffalo bill,1,0,0,0,0,0,1
al'qaeda,1,0,0,0,0,0,1
airliner,1,0,0,0,0,0,1
i̇lyas,1,0,0,0,0,0,1
united airlines,1,0,0,0,0,0,1
nsa agents,1,0,0,0,0,0,1
osama,1,0,0,0,0,0,1
mckees,1,0,0,0,0,0,1
eleven,1,0,0,0,0,0,1
airlines,1,0,0,0,0,0,1
gvozden,1,0,0,0,0,0,1
crawford,1,0,0,0,0,0,1
admiral mckee,1,0,0,0,0,0,1
clarice starling,1,0,0,0,0,0,1
starling,1,0,0,0,0,0,1
istanbul,1,0,0,0,0,0,1
dilek,1,0,0,0,0,0,1
cemşit,1,0,0,0,0,0,1
yazmalım,1,0,0,0,0,0,1
goggles,1,0,0,0,0,0,1
annotation,1,0,0,0,0,0,1
ilyas,1,0,0,0,0,0,1
the baltimore state hospital,1,0,0,0,0,0,1
congress,1,0,0,0,0,0,1
the department of homeland security,1,0,0,0,0,0,1
mckee,1,0,0,0,0,0,1
precision,1,0,0,0,0,0,1
binder,1,0,0,0,0,0,1
quantico,1,0,0,0,0,0,1
jdams,1,0,0,0,0,0,1
melissa,1,0,0,0,0,0,1
the office of homeland security,1,0,0,0,0,0,1
nine,1,0,0,0,0,0,1
the bosnian serb army,1,0,0,0,0,0,1
anandan,1,0,0,0,0,0,1
m-60,1,0,0,0,0,0,1
controversy,1,0,0,0,0,0,1
yugoslav,1,0,0,0,0,0,1
eastern bosnia,1,0,0,0,0,0,1
tabu,1,0,0,0,0,0,1
pushpa,1,0,0,0,0,0,1
tamizhselvan,1,0,0,0,0,0,1
handshake,1,0,0,0,0,0,1
discomfort,1,0,0,0,0,0,1
jubilates,1,0,0,0,0,0,1
draft,1,0,0,0,0,0,1
nikola gardović,1,0,0,0,0,0,1
dragan,1,0,0,0,0,0,1
footing,1,0,0,0,0,0,1
junkie,1,0,0,0,0,0,1
displeasure,1,0,0,0,0,0,1
sarajevo,1,0,0,0,0,0,1
the cbc news,1,0,0,0,0,0,1
flamers,1,0,0,0,0,0,1
demotion,1,0,0,0,0,0,1
mantle,1,0,0,0,0,0,1
slobo,1,0,0,0,0,0,1
frontlines,1,0,0,0,0,0,1
annachi,1,0,0,0,0,0,1
džemal,1,0,0,0,0,0,1
bosniaks,1,0,0,0,0,0,1
chetnik,1,0,0,0,0,0,1
ramani,1,0,0,0,0,0,1
tamizselvan,1,0,0,0,0,0,1
gardović,1,0,0,0,0,0,1
petar,1,0,0,0,0,0,1
durai,1,0,0,0,0,0,1
tamizhsevan,1,0,0,0,0,0,1
asya,1,0,0,0,0,0,1
decryption,1,0,0,0,0,0,1
merkin,1,0,0,0,0,0,1
zygmunt,1,0,0,0,0,0,1
szpilman,1,0,0,0,0,0,1
deportation,1,0,0,0,0,0,1
janina,1,0,0,0,0,0,1
chijiiwa,1,0,0,0,0,0,1
hosenfeld,1,0,0,0,0,0,1
lednicki,1,0,0,0,0,0,1
polonaise,1,0,0,0,0,0,1
the warsaw uprising,1,0,0,0,0,0,1
fallon/borden,1,0,0,0,0,0,1
nazi germany's,1,0,0,0,0,0,1
the star of david,1,0,0,0,0,0,1
topknot,1,0,0,0,0,0,1
kageyu,1,0,0,0,0,0,1
retelling,1,0,0,0,0,0,1
hayato,1,0,0,0,0,0,1
hanshiro tsugumo,1,0,0,0,0,0,1
tsugomo,1,0,0,0,0,0,1
motome,1,0,0,0,0,0,1
the jewish ghetto police,1,0,0,0,0,0,1
miho,1,0,0,0,0,0,1
władysław,1,0,0,0,0,0,1
alms,1,0,0,0,0,0,1
armband,1,0,0,0,0,0,1
chopin,1,0,0,0,0,0,1
non-jewish,1,0,0,0,0,0,1
andrzej,1,0,0,0,0,0,1
violinist,1,0,0,0,0,0,1
polish radio,1,0,0,0,0,0,1
greatcoat,1,0,0,0,0,0,1
enclosure,1,0,0,0,0,0,1
umenosuke,1,0,0,0,0,0,1
ballade,1,0,0,0,0,0,1
chijiwa,1,0,0,0,0,0,1
hikokuro,1,0,0,0,0,0,1
minor,1,0,0,0,0,0,1
jame,1,0,0,0,0,0,1
nod,1,0,0,0,0,0,1
keyword,1,0,0,0,0,0,1
tesla,1,0,0,0,0,0,1
borden,1,0,0,0,0,0,1
backstage,1,0,0,0,0,0,1
assisting,1,0,0,0,0,0,1
the fbi academy,1,0,0,0,0,0,1
recognises,1,0,0,0,0,0,1
criminally,1,0,0,0,0,0,1
fallon,1,0,0,0,0,0,1
fbi academy,1,0,0,0,0,0,1
preoccupation,1,0,0,0,0,0,1
victimless,1,0,0,0,0,0,1
jess,1,0,0,0,0,0,1
behavioral,1,0,0,0,0,0,1
slaughterhouse,1,0,0,0,0,0,1
discourtesy,1,0,0,0,0,0,1
lecter,1,0,0,0,0,0,1
bimini,1,0,0,0,0,0,1
danton,1,0,0,0,0,0,1
transported,1,0,0,0,0,0,1
caldlow,1,0,0,0,0,0,1
colorado springs,1,0,0,0,0,0,1
pad,1,0,0,0,0,0,1
gumb,1,0,0,0,0,0,1
cutter,1,0,0,0,0,0,1
edison,1,0,0,0,0,0,1
ingénieur,1,0,0,0,0,0,1
resents,1,0,0,0,0,0,1
dove,1,0,0,0,0,0,1
semen,1,0,0,0,0,0,1
abductee,1,0,0,0,0,0,1
alienate,1,0,0,0,0,0,1
cipher,1,0,0,0,0,0,1
hannibal,1,0,0,0,0,0,1
wenscombe,1,0,0,0,0,0,1
angier,1,0,0,0,0,0,1
spokesperson,1,0,0,0,0,0,1
petrović,1,0,0,0,0,0,1
laza,1,0,0,0,0,0,1
tito,1,0,0,0,0,0,1
bosnian serb,1,0,0,0,0,0,1
paint,1,0,0,0,0,0,1
fluoridation,1,0,0,0,0,0,1
b-52,1,0,0,0,0,0,1
liza,1,0,0,0,0,0,1
linel,1,0,0,0,0,0,1
blotter,1,0,0,0,0,0,1
croatian,1,0,0,0,0,0,1
brody,1,0,0,0,0,0,1
breeding,1,0,0,0,0,0,1
"the ""war room""",1,0,0,0,0,0,1
burpelson air force base,1,0,0,0,0,0,1
cobalt,1,0,0,0,0,0,1
kodlosk,1,0,0,0,0,0,1
icbm,1,0,0,0,0,0,1
1980s,1,0,0,0,0,0,1
srbija,1,0,0,0,0,0,1
u.s. army captain,1,0,0,0,0,0,1
the tunnel of brotherhood and unity,1,0,0,0,0,0,1
coppola,1,0,0,0,0,0,1
brzi,1,0,0,0,0,0,1
ruthlessness,1,0,0,0,0,0,1
u.s. army special forces,1,0,0,0,0,0,1
napalm,1,0,0,0,0,0,1
thrust,1,0,0,0,0,0,1
večernje,1,0,0,0,0,0,1
the viet cong,1,0,0,0,0,0,1
montagnard,1,0,0,0,0,0,1
exploding,1,0,0,0,0,0,1
corman,1,0,0,0,0,0,1
loudspeaker,1,0,0,0,0,0,1
clean,1,0,0,0,0,0,1
dignitary,1,0,0,0,0,0,1
kurtz,1,0,0,0,0,0,1
marko,1,0,0,0,0,0,1
dimitri,1,0,0,0,0,0,1
101st,1,0,0,0,0,0,1
merderet,1,0,0,0,0,0,1
mineshaft,1,0,0,0,0,0,1
muffley,1,0,0,0,0,0,1
soviets,1,0,0,0,0,0,1
doomsday,1,0,0,0,0,0,1
major kong,1,0,0,0,0,0,1
radar,1,0,0,0,0,0,1
d.,1,0,0,0,0,0,1
discriminator,1,0,0,0,0,0,1
lynn,1,0,0,0,0,0,1
sadeski,1,0,0,0,0,0,1
p-51,1,0,0,0,0,0,1
activation,1,0,0,0,0,0,1
omaha,1,0,0,0,0,0,1
authorization,1,0,0,0,0,0,1
rodeo,1,0,0,0,0,0,1
m4,1,0,0,0,0,0,1
recall,1,0,0,0,0,0,1
united states',1,0,0,0,0,0,1
ripper,1,0,0,0,0,0,1
doodle,1,0,0,0,0,0,1
upham,1,0,0,0,0,0,1
vera,1,0,0,0,0,0,1
kisov,1,0,0,0,0,0,1
wade,1,0,0,0,0,0,1
alexei,1,0,0,0,0,0,1
burpelson,1,0,0,0,0,0,1
führer,1,0,0,0,0,0,1
the war room,1,0,0,0,0,0,1
114,1,0,0,0,0,0,1
aftereffect,1,0,0,0,0,0,1
normandy,1,0,0,0,0,0,1
new york times,1,0,0,0,0,0,1
crm,1,0,0,0,0,0,1
ussr,1,0,0,0,0,0,1
thorium,1,0,0,0,0,0,1
lucas,1,0,0,0,0,0,1
coastline,1,0,0,0,0,0,1
hostile,1,0,0,0,0,0,1
obligation,1,0,0,0,0,0,1
veeyanna,1,0,0,0,0,0,1
endears,1,0,0,0,0,0,1
precondition,1,0,0,0,0,0,1
pleader,1,0,0,0,0,0,1
chitti,1,0,0,0,0,0,1
scrooge,1,0,0,0,0,0,1
recital,1,0,0,0,0,0,1
ammadu,1,0,0,0,0,0,1
gumasta,1,0,0,0,0,0,1
graffiti,1,0,0,0,0,0,1
viljuška,1,0,0,0,0,0,1
drina,1,0,0,0,0,0,1
jun.,1,0,0,0,0,0,1
envy,1,0,0,0,0,0,1
lieu,1,0,0,0,0,0,1
ot,1,0,0,0,0,0,1
govindaiah,1,0,0,0,0,0,1
styling,1,0,0,0,0,0,1
relapse,1,0,0,0,0,0,1
russo,1,0,0,0,0,0,1
bronski,1,0,0,0,0,0,1
banja,1,0,0,0,0,0,1
firefights,1,0,0,0,0,0,1
elope,1,0,0,0,0,0,1
bijedić,1,0,0,0,0,0,1
achootys,1,0,0,0,0,0,1
achootty,1,0,0,0,0,0,1
chap,1,0,0,0,0,0,1
amaram,1,0,0,0,0,0,1
venkatapathy,1,0,0,0,0,0,1
relent,1,0,0,0,0,0,1
overpass,1,0,0,0,0,0,1
madness,1,0,0,0,0,0,1
eastern,1,0,0,0,0,0,1
headband,1,0,0,0,0,0,1
buyout,1,0,0,0,0,0,1
tyrone,1,0,0,0,0,0,1
cbc,1,0,0,0,0,0,1
jna,1,0,0,0,0,0,1
kilgore,1,0,0,0,0,0,1
nung,1,0,0,0,0,0,1
uso,1,0,0,0,0,0,1
the nung river,1,0,0,0,0,0,1
surfer,1,0,0,0,0,0,1
cambodian,1,0,0,0,0,0,1
playmates,1,0,0,0,0,0,1
delay,1,0,0,0,0,0,1
banja luka,1,0,0,0,0,0,1
petty,1,0,0,0,0,0,1
cong,1,0,0,0,0,0,1
colby,1,0,0,0,0,0,1
kafana,1,0,0,0,0,0,1
novosti,1,0,0,0,0,0,1
milan,1,0,0,0,0,0,1
pbr,1,0,0,0,0,0,1
collateral,1,0,0,0,0,0,1
sampan,1,0,0,0,0,0,1
jun,1,0,0,0,0,0,1
gondo,1,0,0,0,0,0,1
intern,1,0,0,0,0,0,1
contemplation,1,0,0,0,0,0,1
shinichi,1,0,0,0,0,0,1
playmate,1,0,0,0,0,0,1
halil,1,0,0,0,0,0,1
national shoes,1,0,0,0,0,0,1
the national shoe company,1,0,0,0,0,0,1
machete,1,0,0,0,0,0,1
chef and lance,1,0,0,0,0,0,1
viet,1,0,0,0,0,0,1
the belgrade military hospital,1,0,0,0,0,0,1
airstrikes,1,0,0,0,0,0,1
velja,1,0,0,0,0,0,1
horrid,1,0,0,0,0,0,1
bogucki,1,0,0,0,0,0,1
jaundice,1,0,0,0,0,0,1
the briar ridge mental hospital,1,0,0,0,0,0,1
mental,1,0,0,0,0,0,1
modern,1,0,0,0,0,0,1
stretch,1,0,0,0,0,0,1
brutus,1,0,0,0,0,0,1
delirium,1,0,0,0,0,0,1
briar,1,0,0,0,0,0,1
cuff,1,0,0,0,0,0,1
jailbreak,1,0,0,0,0,0,1
proximo,1,0,0,0,0,0,1
wharton,1,0,0,0,0,0,1
tract,1,0,0,0,0,0,1
modern times,1,0,0,0,0,0,1
instigator,1,0,0,0,0,0,1
coffey,1,0,0,0,0,0,1
brutal,1,0,0,0,0,0,1
edgecomb,1,0,0,0,0,0,1
amalgam,1,0,0,0,0,0,1
cafeteria,1,0,0,0,0,0,1
terwilliger,1,0,0,0,0,0,1
indignity,1,0,0,0,0,0,1
south boston,1,0,0,0,0,0,1
the federal bureau of investigation,1,0,0,0,0,0,1
linoleum,1,0,0,0,0,0,1
catatonia,1,0,0,0,0,0,1
barrigan,1,0,0,0,0,0,1
sponge,1,0,0,0,0,0,1
jingles,1,0,0,0,0,0,1
madden,1,0,0,0,0,0,1
the massachusetts state police,1,0,0,0,0,0,1
howell,1,0,0,0,0,0,1
footies,1,0,0,0,0,0,1
moores,1,0,0,0,0,0,1
madolyn,1,0,0,0,0,0,1
investigations,1,0,0,0,0,0,1
cold mountain penitentiary,1,0,0,0,0,0,1
gamine,1,0,0,0,0,0,1
machinery,1,0,0,0,0,0,1
delacroix,1,0,0,0,0,0,1
thalapathi,1,0,0,0,0,0,1
kalivardhan,1,0,0,0,0,0,1
surya,1,0,0,0,0,0,1
guido,1,0,0,0,0,0,1
orefice,1,0,0,0,0,0,1
reghuraman,1,0,0,0,0,0,1
non-jew,1,0,0,0,0,0,1
giosuè,1,0,0,0,0,0,1
reguraman,1,0,0,0,0,0,1
begin,1,0,0,0,0,0,1
asram,1,0,0,0,0,0,1
knockout,1,0,0,0,0,0,1
thieving,1,0,0,0,0,0,1
hindus,1,0,0,0,0,0,1
clipper,1,0,0,0,0,0,1
blackie,1,0,0,0,0,0,1
dora,1,0,0,0,0,0,1
nyayamnu,1,0,0,0,0,0,1
dasharna,1,0,0,0,0,0,1
uncle eliseo,1,0,0,0,0,0,1
hurdle,1,0,0,0,0,0,1
singha,1,0,0,0,0,0,1
buckingham,1,0,0,0,0,0,1
vikrama,1,0,0,0,0,0,1
aditya,1,0,0,0,0,0,1
vardhana,1,0,0,0,0,0,1
avanti,1,0,0,0,0,0,1
alaknanda,1,0,0,0,0,0,1
devarajan,1,0,0,0,0,0,1
guido orefice,1,0,0,0,0,0,1
irrukku,1,0,0,0,0,0,1
sweatbox,1,0,0,0,0,0,1
deva/surya,1,0,0,0,0,0,1
betrothal,1,0,0,0,0,0,1
eliseo,1,0,0,0,0,0,1
wetmore,1,0,0,0,0,0,1
delahunt,1,0,0,0,0,0,1
costello,1,0,0,0,0,0,1
dealing,1,0,0,0,0,0,1
venice,1,0,0,0,0,0,1
manslaughter,1,0,0,0,0,0,1
kobe,1,0,0,0,0,0,1
cameron,1,0,0,0,0,0,1
the imperial japanese navy,1,0,0,0,0,0,1
kampf,1,0,0,0,0,0,1
neo-nazi,1,0,0,0,0,0,1
crips,1,0,0,0,0,0,1
entertainment weekly,1,0,0,0,0,0,1
the california institution for men,1,0,0,0,0,0,1
provokes,1,0,0,0,0,0,1
ilsa,1,0,0,0,0,0,1
stacey,1,0,0,0,0,0,1
the aryan brotherhood,1,0,0,0,0,0,1
compton,1,0,0,0,0,0,1
little henry,1,0,0,0,0,0,1
dying,1,0,0,0,0,0,1
lisbon,1,0,0,0,0,0,1
b-29,1,0,0,0,0,0,1
the allied powers,1,0,0,0,0,0,1
firebombing,1,0,0,0,0,0,1
sannomiya,1,0,0,0,0,0,1
bomblet,1,0,0,0,0,0,1
setsuko,1,0,0,0,0,0,1
leftover,1,0,0,0,0,0,1
seita,1,0,0,0,0,0,1
lease,1,0,0,0,0,0,1
fireflies,1,0,0,0,0,0,1
hallucinating,1,0,0,0,0,0,1
malnutrition,1,0,0,0,0,0,1
supremacist,1,0,0,0,0,0,1
whitty,1,0,0,0,0,0,1
venice beach,1,0,0,0,0,0,1
chino,1,0,0,0,0,0,1
brazzaville,1,0,0,0,0,0,1
vichy,1,0,0,0,0,0,1
infiltrator,1,0,0,0,0,0,1
brittle,1,0,0,0,0,0,1
clientele,1,0,0,0,0,0,1
expatriate,1,0,0,0,0,0,1
broomhilda,1,0,0,0,0,0,1
elaine,1,0,0,0,0,0,1
candie,1,0,0,0,0,0,1
speck,1,0,0,0,0,0,1
the deep south,1,0,0,0,0,0,1
eduard,1,0,0,0,0,0,1
the brittle brothers,1,0,0,0,0,0,1
costigan,1,0,0,0,0,0,1
queenan,1,0,0,0,0,0,1
boston,1,0,0,0,0,0,1
dignam,1,0,0,0,0,0,1
correction,1,0,0,0,0,0,1
the special investigations unit,1,0,0,0,0,0,1
calvin,1,0,0,0,0,0,1
the spanish civil war,1,0,0,0,0,0,1
chronology,1,0,0,0,0,0,1
américain,1,0,0,0,0,0,1
mein kampf,1,0,0,0,0,0,1
aryan,1,0,0,0,0,0,1
expulsion,1,0,0,0,0,0,1
chord,1,0,0,0,0,0,1
renault,1,0,0,0,0,0,1
laszlo,1,0,0,0,0,0,1
casablanca,1,0,0,0,0,0,1
blaine,1,0,0,0,0,0,1
proprietor,1,0,0,0,0,0,1
outlook,1,0,0,0,0,0,1
ethiopia,1,0,0,0,0,0,1
strasser,1,0,0,0,0,0,1
aryan brotherhood,1,0,0,0,0,0,1
turf,1,0,0,0,0,0,1
d.o.c.,1,0,0,0,0,0,1
runts,1,0,0,0,0,0,1
germanic,1,0,0,0,0,0,1
the iyi house,1,0,0,0,0,0,1
clarence,1,0,0,0,0,0,1
newsboy,1,0,0,0,0,0,1
rolls-royce,1,0,0,0,0,0,1
rolls,1,0,0,0,0,0,1
sweeper,1,0,0,0,0,0,1
royce,1,0,0,0,0,0,1
today.{{inflation,1,0,0,0,0,0,1
zuzu,1,0,0,0,0,0,1
flower girl,1,0,0,0,0,0,1
flanagan,1,0,0,0,0,0,1
the flower girl's,1,0,0,0,0,0,1
edmunds,1,0,0,0,0,0,1
et,1,0,0,0,0,0,1
bick,1,0,0,0,0,0,1
pickpocket,1,0,0,0,0,0,1
name9806e6dd1031f93ba25752c1a962958260,1,0,0,0,0,0,1
examiner,1,0,0,0,0,0,1
joyously,1,0,0,0,0,0,1
grab,1,0,0,0,0,0,1
bailey park,1,0,0,0,0,0,1
lonelyheart,1,0,0,0,0,0,1
gower,1,0,0,0,0,0,1
fn}}|group,1,0,0,0,0,0,1
packing,1,0,0,0,0,0,1
binoculars,1,0,0,0,0,0,1
fremont,1,0,0,0,0,0,1
new yorkalthough,1,0,0,0,0,0,1
greenwich village,1,0,0,0,0,0,1
pottersville,1,0,0,0,0,0,1
jeffries,1,0,0,0,0,0,1
sawyer,1,0,0,0,0,0,1
greenwich,1,0,0,0,0,0,1
thorwald,1,0,0,0,0,0,1
handsaw,1,0,0,0,0,0,1
songwriter,1,0,0,0,0,0,1
goodrich,1,0,0,0,0,0,1
nypd,1,0,0,0,0,0,1
esu,1,0,0,0,0,0,1
montana,1,0,0,0,0,0,1
save,1,0,0,0,0,0,1
hanshiro,1,0,0,0,0,0,1
new york city's,1,0,0,0,0,0,1
addict,1,0,0,0,0,0,1
lando,1,0,0,0,0,0,1
"friend"",<ref",1,0,0,0,0,0,1
omodaka,1,0,0,0,0,0,1
mathilda,1,0,0,0,0,0,1
houseplant,1,0,0,0,0,0,1
headmistress,1,0,0,0,0,0,1
umenosuke kawabe,1,0,0,0,0,0,1
brillante,1,0,0,0,0,0,1
wilm,1,0,0,0,0,0,1
the warsaw ghetto uprising,1,0,0,0,0,0,1
kawabe,1,0,0,0,0,0,1
extermination,1,0,0,0,0,0,1
sweetie,1,0,0,0,0,0,1
calisthenics,1,0,0,0,0,0,1
wainwright,1,0,0,0,0,0,1
iyi,1,0,0,0,0,0,1
bedford,1,0,0,0,0,0,1
macaroni,1,0,0,0,0,0,1
yorkalthough,1,0,0,0,0,0,1
al. 1986,1,0,0,0,0,0,1
"the ""supreme macaroni company""",1,0,0,0,0,0,1
leone,1,0,0,0,0,0,1
giuseppe,1,0,0,0,0,0,1
stansfield,1,0,0,0,0,0,1
dea&nbsp;agents,1,0,0,0,0,0,1
serviceman,1,0,0,0,0,0,1
léon,1,0,0,0,0,0,1
librarian,1,0,0,0,0,0,1
tsugumo,1,0,0,0,0,0,1
yazaki,1,0,0,0,0,0,1
the new york times,1,0,0,0,0,0,1
cigar,1,0,0,0,0,0,1
adventures,1,0,0,0,0,0,1
l.b.,1,0,0,0,0,0,1
figurine,1,0,0,0,0,0,1
praetorian,1,0,0,0,0,0,1
lucilla,1,0,0,0,0,0,1
colosseum,1,0,0,0,0,0,1
hippy,1,0,0,0,0,0,1
juba,1,0,0,0,0,0,1
runt,1,0,0,0,0,0,1
the battle of zama,1,0,0,0,0,0,1
commodus,1,0,0,0,0,0,1
fanbase,1,0,0,0,0,0,1
burnett,1,0,0,0,0,0,1
insider,1,0,0,0,0,0,1
demo,1,0,0,0,0,0,1
favela,1,0,0,0,0,0,1
zé,1,0,0,0,0,0,1
exhilirations,1,0,0,0,0,0,1
cidade,1,0,0,0,0,0,1
rob,1,0,0,0,0,0,1
chickens,1,0,0,0,0,0,1
aurelius,1,0,0,0,0,0,1
roman colosseum,1,0,0,0,0,0,1
decimus,1,0,0,0,0,0,1
li'l,1,0,0,0,0,0,1
vermelho,1,0,0,0,0,0,1
gracchus,1,0,0,0,0,0,1
the roman senate,1,0,0,0,0,0,1
tigris,1,0,0,0,0,0,1
comando,1,0,0,0,0,0,1
internship,1,0,0,0,0,0,1
vindobona,1,0,0,0,0,0,1
zucchabar,1,0,0,0,0,0,1
meridius,1,0,0,0,0,0,1
deus,1,0,0,0,0,0,1
photography,1,0,0,0,0,0,1
stiletto,1,0,0,0,0,0,1
cancellation,1,0,0,0,0,0,1
benny,1,0,0,0,0,0,1
p.s.,1,0,0,0,0,0,1
continent,1,0,0,0,0,0,1
centre,1,0,0,0,0,0,1
skynet,1,0,0,0,0,0,1
cpu,1,0,0,0,0,0,1
pan-african,1,0,0,0,0,0,1
overview,1,0,0,0,0,0,1
ancient egypt,1,0,0,0,0,0,1
alloy,1,0,0,0,0,0,1
neighbors,1,0,0,0,0,0,1
cyberdyne systems,1,0,0,0,0,0,1
dyson,1,0,0,0,0,0,1
microprocessor,1,0,0,0,0,0,1
t-800,1,0,0,0,0,0,1
telephoto,1,0,0,0,0,0,1
dear,1,0,0,0,0,0,1
hysteric,1,0,0,0,0,0,1
ancient,1,0,0,0,0,0,1
cyberdyne,1,0,0,0,0,0,1
shaggy,1,0,0,0,0,0,1
fibrosis,1,0,0,0,0,0,1
"the ""tender trio"" –",1,0,0,0,0,0,1
amy,1,0,0,0,0,0,1
imperfecta,1,0,0,0,0,0,1
terminator,1,0,0,0,0,0,1
systems,1,0,0,0,0,0,1
resistance against skynet,1,0,0,0,0,0,1
perez,1,0,0,0,0,0,1
connor,1,0,0,0,0,0,1
prototype,1,0,0,0,0,0,1
t-1000,1,0,0,0,0,0,1
nicholls,1,0,0,0,0,0,1
silberman,1,0,0,0,0,0,1
folder,1,0,0,0,0,0,1
doctors,1,0,0,0,0,0,1
osteogenesis,1,0,0,0,0,0,1
mandrake,1,0,0,0,0,0,1
turgidson,1,0,0,0,0,0,1
lauren,1,0,0,0,0,0,1
lamprecht,1,0,0,0,0,0,1
dax,1,0,0,0,0,0,1
régiment,1,0,0,0,0,0,1
scapegoat,1,0,0,0,0,0,1
farce,1,0,0,0,0,0,1
perk,1,0,0,0,0,0,1
the french general staff,1,0,0,0,0,0,1
vigo,1,0,0,0,0,0,1
spezia,1,0,0,0,0,0,1
world war i up to,1,0,0,0,0,0,1
gibraltar,1,0,0,0,0,0,1
u,1,0,0,0,0,0,1
ballast,1,0,0,0,0,0,1
la rochelle,1,0,0,0,0,0,1
hinrich,1,0,0,0,0,0,1
the strait of gibraltar &,1,0,0,0,0,0,1
df,1,0,0,0,0,0,1
commencement,1,0,0,0,0,0,1
exists,1,0,0,0,0,0,1
mireau,1,0,0,0,0,0,1
broulard,1,0,0,0,0,0,1
scouting,1,0,0,0,0,0,1
folk,1,0,0,0,0,0,1
the french army,1,0,0,0,0,0,1
undesirable,1,0,0,0,0,0,1
authenticity,1,0,0,0,0,0,1
typist,1,0,0,0,0,0,1
arnaud,1,0,0,0,0,0,1
gentlemen,1,0,0,0,0,0,1
gent,1,0,0,0,0,0,1
corporal paris,1,0,0,0,0,0,1
hussar,1,0,0,0,0,0,1
gloating,1,0,0,0,0,0,1
falsifies,1,0,0,0,0,0,1
the witness protection program,1,0,0,0,0,0,1
paulie,1,0,0,0,0,0,1
devito,1,0,0,0,0,0,1
misfortune,1,0,0,0,0,0,1
werner,1,0,0,0,0,0,1
consulate,1,0,0,0,0,0,1
schnook,1,0,0,0,0,0,1
metre,1,0,0,0,0,0,1
viewpoint,1,0,0,0,0,0,1
thomsen,1,0,0,0,0,0,1
ritterkreuz,1,0,0,0,0,0,1
eames,1,0,0,0,0,0,1
conglomerate,1,0,0,0,0,0,1
boredom,1,0,0,0,0,0,1
frenssen,1,0,0,0,0,0,1
tamaki,1,0,0,0,0,0,1
pomp,1,0,0,0,0,0,1
bailiff,1,0,0,0,0,0,1
poignant,1,0,0,0,0,0,1
sansho's,1,0,0,0,0,0,1
fischer,1,0,0,0,0,0,1
shelf,1,0,0,0,0,0,1
lucchese,1,0,0,0,0,0,1
u-96,1,0,0,0,0,0,1
johann,1,0,0,0,0,0,1
rossi,1,0,0,0,0,0,1
torpedo,1,0,0,0,0,0,1
weser,1,0,0,0,0,0,1
hf,1,0,0,0,0,0,1
copacabana,1,0,0,0,0,0,1
resupplying,1,0,0,0,0,0,1
rochelle,1,0,0,0,0,0,1
hf/df,1,0,0,0,0,0,1
hijacking,1,0,0,0,0,0,1
bootsmann,1,0,0,0,0,0,1
la spezia,1,0,0,0,0,0,1
ullmann,1,0,0,0,0,0,1
envoy,1,0,0,0,0,0,1
gambino,1,0,0,0,0,0,1
spotting,1,0,0,0,0,0,1
rousseau,1,0,0,0,0,0,1
blindfold,1,0,0,0,0,0,1
mer,1,0,0,0,0,0,1
machines,1,0,0,0,0,0,1
morpheus,1,0,0,0,0,0,1
renown,1,0,0,0,0,0,1
decrease,1,0,0,0,0,0,1
berridge,1,0,0,0,0,0,1
offstage,1,0,0,0,0,0,1
più,1,0,0,0,0,0,1
mediocrity,1,0,0,0,0,0,1
levitating,1,0,0,0,0,0,1
private arnaud,1,0,0,0,0,0,1
dozer,1,0,0,0,0,0,1
constanze,1,0,0,0,0,0,1
hieronymus,1,0,0,0,0,0,1
emp,1,0,0,0,0,0,1
zion,1,0,0,0,0,0,1
amadeus,1,0,0,0,0,0,1
salieri,1,0,0,0,0,0,1
trifle,1,0,0,0,0,0,1
requiem,1,0,0,0,0,0,1
devout,1,0,0,0,0,0,1
trinity,1,0,0,0,0,0,1
fleeing,1,0,0,0,0,0,1
dairy,1,0,0,0,0,0,1
oracle,1,0,0,0,0,0,1
life.{{cite,1,0,0,0,0,0,1
apoc,1,0,0,0,0,0,1
fredrick,1,0,0,0,0,0,1
donowitz,1,0,0,0,0,0,1
stiglitz,1,0,0,0,0,0,1
cypher,1,0,0,0,0,0,1
utivich,1,0,0,0,0,0,1
raine,1,0,0,0,0,0,1
landa,1,0,0,0,0,0,1
hacker,1,0,0,0,0,0,1
andrai,1,0,0,0,0,0,1
colloredo,1,0,0,0,0,0,1
programmer,1,0,0,0,0,0,1
vogler,1,0,0,0,0,0,1
dictate,1,0,0,0,0,0,1
kraj,1,0,0,0,0,0,1
publishing,1,0,0,0,0,0,1
national security,1,0,0,0,0,0,1
antiregime,1,0,0,0,0,0,1
laban,1,0,0,0,0,0,1
state security,1,0,0,0,0,0,1
roget,1,0,0,0,0,0,1
towns,1,0,0,0,0,0,1
east new york,1,0,0,0,0,0,1
titles,1,0,0,0,0,0,1
truancy,1,0,0,0,0,0,1
acquittal,1,0,0,0,0,0,1
morris,1,0,0,0,0,0,1
701,1,0,0,0,0,0,1
ferol,1,0,0,0,0,0,1
batts,1,0,0,0,0,0,1
jovan,1,0,0,0,0,0,1
ana,1,0,0,0,0,0,1
nebuchadnezzar,1,0,0,0,0,0,1
teodor,1,0,0,0,0,0,1
mozart,1,0,0,0,0,0,1
tribulation,1,0,0,0,0,0,1
mainframe,1,0,0,0,0,0,1
composing,1,0,0,0,0,0,1
commerce,1,0,0,0,0,0,1
shoeshine,1,0,0,0,0,0,1
janice,1,0,0,0,0,0,1
ounce,1,0,0,0,0,0,1
transcribes,1,0,0,0,0,0,1
italians,1,0,0,0,0,0,1
slobodan,1,0,0,0,0,0,1
lufthansa,1,0,0,0,0,0,1
stories,1,0,0,0,0,0,1
milošević,1,0,0,0,0,0,1
teja,1,0,0,0,0,0,1
statuette,1,0,0,0,0,0,1
proverb,1,0,0,0,0,0,1
jidai,1,0,0,0,0,0,1
keyes,1,0,0,0,0,0,1
chemist,1,0,0,0,0,0,1
intercept,1,0,0,0,0,0,1
dietrichson,1,0,0,0,0,0,1
indemnity,1,0,0,0,0,0,1
adjuster,1,0,0,0,0,0,1
statistic,1,0,0,0,0,0,1
libido,1,0,0,0,0,0,1
lola,1,0,0,0,0,0,1
forger,1,0,0,0,0,0,1
memo,1,0,0,0,0,0,1
investigator keyes,1,0,0,0,0,0,1
unfaithfulness,1,0,0,0,0,0,1
improbability,1,0,0,0,0,0,1
endorsement,1,0,0,0,0,0,1
dictation,1,0,0,0,0,0,1
haze,1,0,0,0,0,0,1
palo alto,1,0,0,0,0,0,1
crutch,1,0,0,0,0,0,1
pacific all risk,1,0,0,0,0,0,1
voltage,1,0,0,0,0,0,1
byers,1,0,0,0,0,0,1
genocide,1,0,0,0,0,0,1
irene,1,0,0,0,0,0,1
vikram,1,0,0,0,0,0,1
gomathy,1,0,0,0,0,0,1
ganja,1,0,0,0,0,0,1
chithan,1,0,0,0,0,0,1
chithan that sakthi,1,0,0,0,0,0,1
spectrum,1,0,0,0,0,0,1
autism,1,0,0,0,0,0,1
whirl,1,0,0,0,0,0,1
seller,1,0,0,0,0,0,1
mal,1,0,0,0,0,0,1
brazen,1,0,0,0,0,0,1
neff,1,0,0,0,0,0,1
dictaphone,1,0,0,0,0,0,1
cavett,1,0,0,0,0,0,1
alto,1,0,0,0,0,0,1
forrest jr.,1,0,0,0,0,0,1
dragnet,1,0,0,0,0,0,1
trejo,1,0,0,0,0,0,1
homicide,1,0,0,0,0,0,1
waingro,1,0,0,0,0,0,1
nate,1,0,0,0,0,0,1
marciano,1,0,0,0,0,0,1
gage,1,0,0,0,0,0,1
depository,1,0,0,0,0,0,1
mccauley,1,0,0,0,0,0,1
necessity,1,0,0,0,0,0,1
charlene,1,0,0,0,0,0,1
forbids,1,0,0,0,0,0,1
lapd,1,0,0,0,0,0,1
bondsman,1,0,0,0,0,0,1
the watergate,1,0,0,0,0,0,1
shiherlis,1,0,0,0,0,0,1
ooty,1,0,0,0,0,0,1
phyllis,1,0,0,0,0,0,1
nehalata,1,0,0,0,0,0,1
gullibility,1,0,0,0,0,0,1
gump,1,0,0,0,0,0,1
sarasa,1,0,0,0,0,0,1
kittu,1,0,0,0,0,0,1
wastrel,1,0,0,0,0,0,1
panciker,1,0,0,0,0,0,1
kittu panicker,1,0,0,0,0,0,1
barrister,1,0,0,0,0,0,1
balan,1,0,0,0,0,0,1
the court of law and,1,0,0,0,0,0,1
kittu panciker,1,0,0,0,0,0,1
panicker,1,0,0,0,0,0,1
prabhakara,1,0,0,0,0,0,1
aptitude,1,0,0,0,0,0,1
reshmi,1,0,0,0,0,0,1
u.s. army captain byers,1,0,0,0,0,0,1
reichskonkordat,1,0,0,0,0,0,1
haywood,1,0,0,0,0,0,1
koishikawa,1,0,0,0,0,0,1
discerns,1,0,0,0,0,0,1
rokusuke,1,0,0,0,0,0,1
noboru,1,0,0,0,0,0,1
yasumoto,1,0,0,0,0,0,1
nagasaki,1,0,0,0,0,0,1
mantis,1,0,0,0,0,0,1
magnitude,1,0,0,0,0,0,1
akahige,1,0,0,0,0,0,1
maycomb,1,0,0,0,0,0,1
molesting,1,0,0,0,0,0,1
antibody,1,0,0,0,0,0,1
prevalent,1,0,0,0,0,0,1
pageant,1,0,0,0,0,0,1
jem,1,0,0,0,0,0,1
atticus,1,0,0,0,0,0,1
otoyo,1,0,0,0,0,0,1
landslide,1,0,0,0,0,0,1
hymen,1,0,0,0,0,0,1
totem,1,0,0,0,0,0,1
dominick,1,0,0,0,0,0,1
geki,1,0,0,0,0,0,1
zushio,1,0,0,0,0,0,1
acknowledgement,1,0,0,0,0,0,1
taro - sansho’s,1,0,0,0,0,0,1
priestess,1,0,0,0,0,0,1
governors,1,0,0,0,0,0,1
sado,1,0,0,0,0,0,1
dreaming,1,0,0,0,0,0,1
namiji,1,0,0,0,0,0,1
sansho,1,0,0,0,0,0,1
trickster,1,0,0,0,0,0,1
sahachi,1,0,0,0,0,0,1
niide,1,0,0,0,0,0,1
kyojō,1,0,0,0,0,0,1
ewell,1,0,0,0,0,0,1
mayella,1,0,0,0,0,0,1
eugenics,1,0,0,0,0,0,1
b. traven,1,0,0,0,0,0,1
dom,1,0,0,0,0,0,1
kidney,1,0,0,0,0,0,1
richman,1,0,0,0,0,0,1
repents,1,0,0,0,0,0,1
mani,1,0,0,0,0,0,1
janning,1,0,0,0,0,0,1
hitler.{{fact,1,0,0,0,0,0,1
u.s. supreme court,1,0,0,0,0,0,1
allies,1,0,0,0,0,0,1
nuremberg,1,0,0,0,0,0,1
the hitler-vatican reichskonkordat,1,0,0,0,0,0,1
ernst,1,0,0,0,0,0,1
wendell,1,0,0,0,0,0,1
wallner,1,0,0,0,0,0,1
mallorie,1,0,0,0,0,0,1
provider,1,0,0,0,0,0,1
ariadne,1,0,0,0,0,0,1
framework,1,0,0,0,0,0,1
viceroy,1,0,0,0,0,0,1
radley,1,0,0,0,0,0,1
stir,1,0,0,0,0,0,1
healer,1,0,0,0,0,0,1
lifespan,1,0,0,0,0,0,1
attains,1,0,0,0,0,0,1
the third guest,1,0,0,0,0,0,1
yusuf,1,0,0,0,0,0,1
factor,1,0,0,0,0,0,1
merchandise,1,0,0,0,0,0,1
traven,1,0,0,0,0,0,1
inception,1,0,0,0,0,0,1
macario,1,0,0,0,0,0,1
cobb,1,0,0,0,0,0,1
dishonor,1,0,0,0,0,0,1
colonial mexico,1,0,0,0,0,0,1
mimieux,1,0,0,0,0,0,1
1st,1,0,0,0,0,0,1
napkin,1,0,0,0,0,0,1
sieland,1,0,0,0,0,0,1
ranger battalion,1,0,0,0,0,0,1
department m,1,0,0,0,0,0,1
smuggling,1,0,0,0,0,0,1
straße,1,0,0,0,0,0,1
archives,1,0,0,0,0,0,1
democratic,1,0,0,0,0,0,1
pro-communist,1,0,0,0,0,0,1
reunification,1,0,0,0,0,0,1
gammell,1,0,0,0,0,0,1
506th parachute infantry regiment,1,0,0,0,0,0,1
christa,1,0,0,0,0,0,1
menschen,1,0,0,0,0,0,1
dreyman,1,0,0,0,0,0,1
the german democratic republic,1,0,0,0,0,0,1
the stasi archives,1,0,0,0,0,0,1
vom,1,0,0,0,0,0,1
dank,1,0,0,0,0,0,1
spiegel,1,0,0,0,0,0,1
wiesler,1,0,0,0,0,0,1
mustangs,1,0,0,0,0,0,1
laali brar,1,0,0,0,0,0,1
mitti,1,0,0,0,0,0,1
infantry division,1,0,0,0,0,0,1
mms,1,0,0,0,0,0,1
reiben,1,0,0,0,0,0,1
dv,1,0,0,0,0,0,1
sarabjit,1,0,0,0,0,0,1
horvath,1,0,0,0,0,0,1
neeru,1,0,0,0,0,0,1
gaazi dhillon,1,0,0,0,0,0,1
jeet,1,0,0,0,0,0,1
gaazi,1,0,0,0,0,0,1
sidhu,1,0,0,0,0,0,1
caparzo,1,0,0,0,0,0,1
harmail,1,0,0,0,0,0,1
hgw,1,0,0,0,0,0,1
gdr,1,0,0,0,0,0,1
hempf,1,0,0,0,0,0,1
jerska,1,0,0,0,0,0,1
thrissur,1,0,0,0,0,0,1
keralaite,1,0,0,0,0,0,1
grantz,1,0,0,0,0,0,1
whisper,1,0,0,0,0,0,1
scruple,1,0,0,0,0,0,1
transition,1,0,0,0,0,0,1
jayakrishan,1,0,0,0,0,0,1
dodd,1,0,0,0,0,0,1
thnagal,1,0,0,0,0,0,1
jankis,1,0,0,0,0,0,1
claras,1,0,0,0,0,0,1
wedlock,1,0,0,0,0,0,1
exposition,1,0,0,0,0,0,1
natalie,1,0,0,0,0,0,1
maul,1,0,0,0,0,0,1
west german,1,0,0,0,0,0,1
heinrich,1,0,0,0,0,0,1
stasi,1,0,0,0,0,0,1
jayakrishnan,1,0,0,0,0,0,1
gerd,1,0,0,0,0,0,1
grubitz,1,0,0,0,0,0,1
heine,1,0,0,0,0,0,1
east german,1,0,0,0,0,0,1
authorship,1,0,0,0,0,0,1
republic,1,0,0,0,0,0,1
hauptmann,1,0,0,0,0,0,1
ottapalam,1,0,0,0,0,0,1
guten,1,0,0,0,0,0,1
east germany,1,0,0,0,0,0,1
bruno,1,0,0,0,0,0,1
sonate,1,0,0,0,0,0,1
rains,1,0,0,0,0,0,1
west germany,1,0,0,0,0,0,1
advancement,1,0,0,0,0,0,1
tunda,1,0,0,0,0,0,1
dhillon,1,0,0,0,0,0,1
kisaan,1,0,0,0,0,0,1
pugazhendhi's government,1,0,0,0,0,0,1
pughazhendi,1,0,0,0,0,0,1
p.a.,1,0,0,0,0,0,1
29th,1,0,0,0,0,0,1
lawsuit,1,0,0,0,0,0,1
101st airborne division,1,0,0,0,0,0,1
bixby,1,0,0,0,0,0,1
airborne,1,0,0,0,0,0,1
pugazh,1,0,0,0,0,0,1
pugazhendhi,1,0,0,0,0,0,1
unwillingness,1,0,0,0,0,0,1
working,1,0,0,0,0,0,1
improvement,1,0,0,0,0,0,1
the normandy american cemetery and memorial,1,0,0,0,0,0,1
sur,1,0,0,0,0,0,1
pughazh,1,0,0,0,0,0,1
mustang,1,0,0,0,0,0,1
mayakrishnan,1,0,0,0,0,0,1
raghuvaran,1,0,0,0,0,0,1
the indian civil service examination,1,0,0,0,0,0,1
gen.,1,0,0,0,0,0,1
minnesota,1,0,0,0,0,0,1
vera lynn's,1,0,0,0,0,0,1
sac,1,0,0,0,0,0,1
ratio,1,0,0,0,0,0,1
guano,1,0,0,0,0,0,1
neuville,1,0,0,0,0,0,1
again,1,0,0,0,0,0,1
strangelove,1,0,0,0,0,0,1
pughazhendhi,1,0,0,0,0,0,1
aranganathan,1,0,0,0,0,0,1
506th,1,0,0,0,0,0,1
ordinance,1,0,0,0,0,0,1
a bomb squad,1,0,0,0,0,0,1
q,1,0,0,0,0,0,1
ramelle,1,0,0,0,0,0,1
cm,1,0,0,0,0,0,1
lalli,1,0,0,0,0,0,1
shyama,1,0,0,0,0,0,1
amudha to sri lanka,1,0,0,0,0,0,1
steamboat,1,0,0,0,0,0,1
manipulation,1,0,0,0,0,0,1
urge,1,0,0,0,0,0,1
sinhalese,1,0,0,0,0,0,1
"thiruchelvan, amudha",1,0,0,0,0,0,1
colleville,1,0,0,0,0,0,1
vinay,1,0,0,0,0,0,1
eelam,1,0,0,0,0,0,1
rameswaram,1,0,0,0,0,0,1
akhil,1,0,0,0,0,0,1
vikramsinghe,1,0,0,0,0,0,1
herold,1,0,0,0,0,0,1
ltte,1,0,0,0,0,0,1
the merderet river,1,0,0,0,0,0,1
the eelam tamil nation,1,0,0,0,0,0,1
mellish,1,0,0,0,0,0,1
thenmozhi,1,0,0,0,0,0,1
omaha beach,1,0,0,0,0,0,1
vierville,1,0,0,0,0,0,1
tenure,1,0,0,0,0,0,1
amudha,1,0,0,0,0,0,1
thiruchelvan,1,0,0,0,0,0,1
sri lankan,1,0,0,0,0,0,1
tigers,1,0,0,0,0,0,1
overwhelms,1,0,0,0,0,0,1
dileepan,1,0,0,0,0,0,1
mankulam,1,0,0,0,0,0,1
tamils,1,0,0,0,0,0,1
sri lankan tamils,1,0,0,0,0,0,1
"amudha, indira",1,0,0,0,0,0,1
narrates,1,0,0,0,0,0,1
lankan,1,0,0,0,0,0,1
marshall,1,0,0,0,0,0,1
mundakkal,1,0,0,0,0,0,1
shelby,1,0,0,0,0,0,1
dieter,1,0,0,0,0,0,1
memon,1,0,0,0,0,0,1
rakesh,1,0,0,0,0,0,1
badshah,1,0,0,0,0,0,1
dubai,1,0,0,0,0,0,1
gul,1,0,0,0,0,0,1
muqadam,1,0,0,0,0,0,1
badshah khan,1,0,0,0,0,0,1
stutter,1,0,0,0,0,0,1
bibbit,1,0,0,0,0,0,1
tattoo,1,0,0,0,0,0,1
investigators,1,0,0,0,0,0,1
the central bureau of investigation,1,0,0,0,0,0,1
mohammed,1,0,0,0,0,0,1
pinball,1,0,0,0,0,0,1
pada,1,0,0,0,0,0,1
nav pada,1,0,0,0,0,0,1
yaqub,1,0,0,0,0,0,1
rdx,1,0,0,0,0,0,1
justification,1,0,0,0,0,0,1
hydrotherapy,1,0,0,0,0,0,1
nav,1,0,0,0,0,0,1
console,1,0,0,0,0,0,1
consultant,1,0,0,0,0,0,1
exosuit,1,0,0,0,0,0,1
apone,1,0,0,0,0,0,1
ect,1,0,0,0,0,0,1
weyland-yutani,1,0,0,0,0,0,1
dietrich,1,0,0,0,0,0,1
evaluation,1,0,0,0,0,0,1
taber,1,0,0,0,0,0,1
booze,1,0,0,0,0,0,1
dropship,1,0,0,0,0,0,1
lv-426,1,0,0,0,0,0,1
terraforming,1,0,0,0,0,0,1
electroshock,1,0,0,0,0,0,1
strung,1,0,0,0,0,0,1
black friday,1,0,0,0,0,0,1
newstrack,1,0,0,0,0,0,1
minority,1,0,0,0,0,0,1
archie,1,0,0,0,0,0,1
basterds,1,0,0,0,0,0,1
bridget,1,0,0,0,0,0,1
hammersmark,1,0,0,0,0,0,1
patter,1,0,0,0,0,0,1
emmanuelle,1,0,0,0,0,0,1
aldo,1,0,0,0,0,0,1
hellstrom,1,0,0,0,0,0,1
certainty,1,0,0,0,0,0,1
shuffle,1,0,0,0,0,0,1
infiltrate,1,0,0,0,0,0,1
sefelt,1,0,0,0,0,0,1
turkle,1,0,0,0,0,0,1
lapadite,1,0,0,0,0,0,1
agitation,1,0,0,0,0,0,1
butz,1,0,0,0,0,0,1
perrier,1,0,0,0,0,0,1
hicox,1,0,0,0,0,0,1
imitation,1,0,0,0,0,0,1
divulge,1,0,0,0,0,0,1
kanu,1,0,0,0,0,0,1
bromden,1,0,0,0,0,0,1
aarthi,1,0,0,0,0,0,1
immunity,1,0,0,0,0,0,1
stolz,1,0,0,0,0,0,1
swastika,1,0,0,0,0,0,1
goebbels,1,0,0,0,0,0,1
zoller,1,0,0,0,0,0,1
projectionist,1,0,0,0,0,0,1
mcmurphy,1,0,0,0,0,0,1
shosanna,1,0,0,0,0,0,1
1st special service force,1,0,0,0,0,0,1
murmur,1,0,0,0,0,0,1
fenech,1,0,0,0,0,0,1
kino,1,0,0,0,0,0,1
stirring,1,0,0,0,0,0,1
processing,1,0,0,0,0,0,1
sulaco,1,0,0,0,0,0,1
tate,1,0,0,0,0,0,1
carnatic,1,0,0,0,0,0,1
autopilot,1,0,0,0,0,0,1
the league of shadows,1,0,0,0,0,0,1
bruce that rachel dawes,1,0,0,0,0,0,1
ra,1,0,0,0,0,0,1
daggett,1,0,0,0,0,0,1
shekeran,1,0,0,0,0,0,1
kunti,1,0,0,0,0,0,1
blackgate,1,0,0,0,0,0,1
blackgate penitentiary,1,0,0,0,0,0,1
largess,1,0,0,0,0,0,1
ghul,1,0,0,0,0,0,1
putrudu,1,0,0,0,0,0,1
remembers,1,0,0,0,0,0,1
janardhanan,1,0,0,0,0,0,1
ayurvedic,1,0,0,0,0,0,1
disarming,1,0,0,0,0,0,1
messaging,1,0,0,0,0,0,1
legislation,1,0,0,0,0,0,1
blake,1,0,0,0,0,0,1
mangalassery,1,0,0,0,0,0,1
batcave,1,0,0,0,0,0,1
miranda,1,0,0,0,0,0,1
takeover,1,0,0,0,0,0,1
bankrupt,1,0,0,0,0,0,1
selina,1,0,0,0,0,0,1
shadows,1,0,0,0,0,0,1
bane,1,0,0,0,0,0,1
harvey dent,1,0,0,0,0,0,1
talia,1,0,0,0,0,0,1
the gotham city police department,1,0,0,0,0,0,1
resignation,1,0,0,0,0,0,1
florence,1,0,0,0,0,0,1
warrier,1,0,0,0,0,0,1
hypnotist,1,0,0,0,0,0,1
shekaran,1,0,0,0,0,0,1
yutani,1,0,0,0,0,0,1
insurrection,1,0,0,0,0,0,1
cheswick,1,0,0,0,0,0,1
goddammit,1,0,0,0,0,0,1
hypersleep,1,0,0,0,0,0,1
privates,1,0,0,0,0,0,1
recidivist,1,0,0,0,0,0,1
plumbing,1,0,0,0,0,0,1
newt,1,0,0,0,0,0,1
sergeant apone,1,0,0,0,0,0,1
mildred,1,0,0,0,0,0,1
colonial marines,1,0,0,0,0,0,1
gorman,1,0,0,0,0,0,1
corporal hicks,1,0,0,0,0,0,1
vasquez,1,0,0,0,0,0,1
ovipositor,1,0,0,0,0,0,1
colonist,1,0,0,0,0,0,1
nurse ratched,1,0,0,0,0,0,1
facehuggers,1,0,0,0,0,0,1
incest,1,0,0,0,0,0,1
hudson,1,0,0,0,0,0,1
banumathi,1,0,0,0,0,0,1
neelakantan,1,0,0,0,0,0,1
nurse mildred ratched,1,0,0,0,0,0,1
mi,1,0,0,0,0,0,1
woo-jin,1,0,0,0,0,0,1
woo-jin's,1,0,0,0,0,0,1
woo,1,0,0,0,0,0,1
do,1,0,0,0,0,0,1
randle,1,0,0,0,0,0,1
imparts,1,0,0,0,0,0,1
sushi,1,0,0,0,0,0,1
soo,1,0,0,0,0,0,1
weyland,1,0,0,0,0,0,1
ratched,1,0,0,0,0,0,1
"burke, gorman",1,0,0,0,0,0,1
camp keowa,0,1,0,0,0,0,1
scoutmaster,0,1,0,0,0,0,1
jerzy,0,0,0,1,0,0,1
reprieve,0,0,1,0,0,0,1
cohen,0,0,1,0,0,0,1
python,0,0,1,0,0,0,1
cds,0,0,1,0,0,0,1
the disinformation company,0,0,1,0,0,0,1
o'shea,0,0,1,0,0,0,1
monty,0,0,1,0,0,0,1
"life""",0,0,1,0,0,0,1
impediment,0,0,1,0,0,0,1
mahamuni,0,0,1,0,0,0,1
mick,0,0,1,0,0,0,1
the people's front of judea,0,0,1,0,0,0,1
r,0,0,1,0,0,0,1
the judean people's front,0,0,1,0,0,0,1
pontius pilate,0,0,1,0,0,0,1
messiah,0,0,1,0,0,0,1
doctrine,0,0,1,0,0,0,1
lineup,0,0,1,0,0,0,1
truism,0,0,1,0,0,0,1
pfj,0,0,1,0,0,0,1
spartacus,0,0,1,0,0,0,1
vishapu,0,0,1,0,0,0,1
chitralekha,0,0,1,0,0,0,1
jaggarayudu,0,0,1,0,0,0,1
sishiyas,0,0,1,0,0,0,1
apsara,0,0,1,0,0,0,1
rajabhat,0,0,1,0,0,0,1
rudraksha,0,0,1,0,0,0,1
mala,0,0,1,0,0,0,1
maharaju,0,0,1,0,0,0,1
disciples,0,0,1,0,0,0,1
misadventure,0,0,1,0,0,0,1
mystic,0,0,1,0,0,0,1
bwian,0,0,1,0,0,0,1
judith,0,0,1,0,0,0,1
the complete illustrated guide,0,0,1,0,0,0,1
illustrated,0,0,1,0,0,0,1
disinformation,0,0,1,0,0,0,1
dvds,0,0,1,0,0,0,1
dwaraka,1,0,0,0,0,0,1
shakuni,1,0,0,0,0,0,1
muska,0,0,1,0,0,0,1
moth,0,0,1,0,0,0,1
backstory,0,0,1,0,0,0,1
toel,0,0,1,0,0,0,1
pazu,0,0,1,0,0,0,1
woodland,0,0,1,0,0,0,1
ul,0,0,1,0,0,0,1
fading,0,0,1,0,0,0,1
calvero,0,0,1,0,0,0,1
ambrose,0,0,1,0,0,0,1
ration,1,0,0,0,0,0,1
comeback,0,0,1,0,0,0,1
world war i. 1914,0,0,1,0,0,0,1
limelight,0,0,1,0,0,0,1
romuska,0,0,1,0,0,0,1
pomme,0,0,1,0,0,0,1
babble,0,0,1,0,0,0,1
apotropaic,0,0,1,0,0,0,1
detochkin,0,0,1,0,0,0,1
yuri,0,0,1,0,0,0,1
resourcefullness,0,0,1,0,0,0,1
podberyozovikov,0,0,1,0,0,0,1
militsiya,0,0,1,0,0,0,1
cite,0,0,1,0,0,0,1
laputa,0,0,1,0,0,0,1
lusheeta,0,0,1,0,0,0,1
goliath,0,0,1,0,0,0,1
laputan,0,0,1,0,0,0,1
abductor,0,0,1,0,0,0,1
flaptors,0,0,1,0,0,0,1
verse,0,0,1,0,0,0,1
dola,0,0,1,0,0,0,1
sheeta,0,0,1,0,0,0,1
steal,0,0,1,0,0,0,1
vimukti,0,0,1,0,0,0,1
posture,0,0,1,0,0,0,1
jafar,0,0,1,0,0,0,1
enchantress,0,0,1,0,0,0,1
pandit,0,0,1,0,0,0,1
flutist,0,0,1,0,0,0,1
jyothirmayi,0,0,1,0,0,0,1
madhav,0,0,1,0,0,0,1
apte,0,0,1,0,0,0,1
wonders,0,0,1,0,0,0,1
iago,0,0,1,0,0,0,1
paramanandayya,0,0,1,0,0,0,1
rough,0,0,1,0,0,0,1
whomever,0,0,1,0,0,0,1
red army,1,0,0,0,0,0,1
aladdin,0,0,1,0,0,0,1
parrot,0,0,1,0,0,0,1
sorcerer,0,0,1,0,0,0,1
grand vizier,0,0,1,0,0,0,1
zwittau-brinnlitz,1,0,0,0,0,0,1
lumière,0,0,1,0,0,0,1
chip,0,0,1,0,0,0,1
west wing,0,0,1,0,0,0,1
daulatram,0,0,1,0,0,0,1
jignesh,0,0,1,0,0,0,1
motel king,0,0,1,0,0,0,1
chandram,0,0,1,0,0,0,1
madhavi,0,0,1,0,0,0,1
veerendra,0,0,1,0,0,0,1
donga,0,0,1,0,0,0,1
kindheartedness,0,0,1,0,0,0,1
gannayya,0,0,1,0,0,0,1
chiranjeevi,0,0,1,0,0,0,1
manchi,0,0,1,0,0,0,1
perfection,0,0,1,0,0,0,1
lumiere,0,0,1,0,0,0,1
potts,0,0,1,0,0,0,1
cogsworth,0,0,1,0,0,0,1
thievery,0,0,1,0,0,0,1
hourglass,0,0,1,0,0,0,1
agrabah,0,0,1,0,0,0,1
keerti,0,0,1,0,0,0,1
the royal court,0,0,1,0,0,0,1
rajah,0,0,1,0,0,0,1
aruna,0,0,1,0,0,0,1
maharajah,0,0,1,0,0,0,1
nandivardhana,0,0,1,0,0,0,1
rajamahal,0,0,1,0,0,0,1
shishiyas,0,0,1,0,0,0,1
indra,0,0,1,0,0,0,1
nandivardhana maharaju,0,0,1,0,0,0,1
divinity,0,0,1,0,0,0,1
undalu,0,0,1,0,0,0,1
shishyas,0,0,1,0,0,0,1
ranjani,0,0,1,0,0,0,1
girija,0,0,1,0,0,0,1
sainthood,0,0,1,0,0,0,1
vijayadurgam,0,0,1,0,0,0,1
kandy,0,0,1,0,0,0,1
pradeep,0,0,1,0,0,0,1
atapattu,0,0,1,0,0,0,1
bollywood,0,0,1,0,0,0,1
hijinks,0,0,1,0,0,0,1
vicissitude,0,0,1,0,0,0,1
citehttp://www.imdb.com/title/tt0157524/plotsummary,0,0,1,0,0,0,1
ranjeet,0,0,1,0,0,0,1
geeta,0,0,1,0,0,0,1
roopa,0,0,1,0,0,0,1
anitha,0,0,1,0,0,0,1
operation reinhard,1,0,0,0,0,0,1
marwari,0,0,1,0,0,0,1
d.j.,0,0,1,0,0,0,1
kobbekaduwa,0,0,1,0,0,0,1
pathirana,0,0,1,0,0,0,1
sarath,0,0,1,0,0,0,1
d.j. atapattu,0,0,1,0,0,0,1
neville,0,0,1,0,0,0,1
montoya,0,0,1,0,0,0,1
greenland,0,0,1,0,0,0,1
pilgrim,0,0,1,0,0,0,1
sankirtans,0,0,1,0,0,0,1
annamayya,0,0,1,0,0,0,1
sasirekha,1,0,0,0,0,0,1
goddess lakshmi,0,0,1,0,0,0,1
saluva,0,0,1,0,0,0,1
laddu,0,0,1,0,0,0,1
sanctum,0,0,1,0,0,0,1
akkalamma,0,0,1,0,0,0,1
fencer,0,0,1,0,0,0,1
workplace,0,0,1,0,0,0,1
meeny,0,0,1,0,0,0,1
ethelred,0,0,1,0,0,0,1
penrose,0,0,1,0,0,0,1
tit-bits,0,0,1,0,0,0,1
balaiah,1,0,0,0,0,0,1
charmer,0,0,1,0,0,0,1
venkateshwara,0,0,1,0,0,0,1
venkateswara,0,0,1,0,0,0,1
"the king, annamayya",0,0,1,0,0,0,1
kadapa district,0,0,1,0,0,0,1
"lord, annamayya",0,0,1,0,0,0,1
lakkavaamba,0,0,1,0,0,0,1
inclusion,0,0,1,0,0,0,1
encriptions,0,0,1,0,0,0,1
narashima,0,0,1,0,0,0,1
ramya,0,0,1,0,0,0,1
nandaka,0,0,1,0,0,0,1
annamacharya,0,0,1,0,0,0,1
kadapa,0,0,1,0,0,0,1
priests,0,0,1,0,0,0,1
prasadam,0,0,1,0,0,0,1
sringara,0,0,1,0,0,0,1
tallapaka,0,0,1,0,0,0,1
timakka,0,0,1,0,0,0,1
footwear,0,0,1,0,0,0,1
caviar,0,0,1,0,0,0,1
banking,0,0,1,0,0,0,1
market.{{cite,0,0,1,0,0,0,1
suffragette,0,0,1,0,0,0,1
sibella,0,0,1,0,0,0,1
nigger,0,0,1,0,0,0,1
ndash}}to,0,0,1,0,0,0,1
tit,0,0,1,0,0,0,1
eeny,0,0,1,0,0,0,1
d'ascoynes,0,0,1,0,0,0,1
draper,0,0,1,0,0,0,1
vault{{spaced,0,0,1,0,0,0,1
ascoyne,0,0,1,0,0,0,1
ndash}}is,0,0,1,0,0,0,1
extravagance,0,0,1,0,0,0,1
the hays office production code,0,0,1,0,0,0,1
kumara,1,0,0,0,0,0,1
hays,0,0,1,0,0,0,1
imprint,0,0,1,0,0,0,1
edwardian,0,0,1,0,0,0,1
leaflet,0,0,1,0,0,0,1
bits,0,0,1,0,0,0,1
boer,0,0,1,0,0,0,1
darkroom,0,0,1,0,0,0,1
dismissal,0,0,1,0,0,0,1
publication,0,0,1,0,0,0,1
duke of chalfont:,0,0,1,0,0,0,1
memoir,0,0,1,0,0,0,1
mazzini,0,0,1,0,0,0,1
reverend,0,0,1,0,0,0,1
d'ascoyne,0,0,1,0,0,0,1
miny,0,0,1,0,0,0,1
edwardian england,0,0,1,0,0,0,1
quandary,0,0,1,0,0,0,1
dukedom,0,0,1,0,0,0,1
horatio,0,0,1,0,0,0,1
berkeley,0,0,1,0,0,0,1
chalfont,0,0,1,0,0,0,1
tirumala venkateswara temple,0,0,1,0,0,0,1
sankeertan,0,0,1,0,0,0,1
tallapaka village,0,0,1,0,0,0,1
buttercup,0,0,1,0,0,0,1
guilder,0,0,1,0,0,0,1
the dread pirate roberts,0,0,1,0,0,0,1
dread,0,0,1,0,0,0,1
humperdinck,0,0,1,0,0,0,1
rugen,0,0,1,0,0,0,1
imprison,0,0,1,0,0,0,1
ghatotkacha,1,0,0,0,0,0,1
lingaiah,1,0,0,0,0,0,1
fezzik,0,0,1,0,0,0,1
simpleton,0,0,1,0,0,0,1
vidyapati,0,0,1,0,0,0,1
bindu,0,0,1,0,0,0,1
storyteller,0,0,1,0,0,0,1
norther,0,0,1,0,0,0,1
auburn,0,0,1,0,0,0,1
florin,0,0,1,0,0,0,1
fire swamp,0,0,1,0,0,0,1
barefoot,0,0,1,0,0,0,1
ghatothkacha,1,0,0,0,0,0,1
humperdinck tortures westley,0,0,1,0,0,0,1
greeting,0,0,1,0,0,0,1
cliffs,0,0,1,0,0,0,1
r.o.u.s.,0,0,1,0,0,0,1
arjuna,1,0,0,0,0,0,1
vizzini,0,0,1,0,0,0,1
unhappiness,0,0,1,0,0,0,1
complement,0,0,1,0,0,0,1
inigo,0,0,1,0,0,0,1
roberts,0,0,1,0,0,0,1
paralysis,0,0,1,0,0,0,1
pandavas,1,0,0,0,0,0,1
kauravas,1,0,0,0,0,0,1
spout,0,0,1,0,0,0,1
the cliffs of insanity,0,0,1,0,0,0,1
storytelling,0,0,1,0,0,0,1
joséphine,0,0,1,0,0,0,1
sringara sankeertan,0,0,1,0,0,0,1
kishore,0,0,1,0,0,0,1
suleiman,0,0,1,0,0,0,1
kaanya,0,0,1,0,0,0,1
babban,0,0,1,0,0,0,1
shivalkar,0,0,1,0,0,0,1
namdev,0,0,1,0,0,0,1
sideline,0,0,1,0,0,0,1
dedh,0,0,1,0,0,0,1
raghunath,0,0,1,0,0,0,1
pav,0,0,1,0,0,0,1
vaastav,0,0,1,0,0,0,1
kadam,0,0,1,0,0,0,1
vitthal,0,0,1,0,0,0,1
brahmins,0,0,1,0,0,0,1
tirumala,0,0,1,0,0,0,1
sanctorum,0,0,1,0,0,0,1
bhaji,0,0,1,0,0,0,1
footiya,0,0,1,0,0,0,1
trivia,0,0,1,0,0,0,1
suleman,0,0,1,0,0,0,1
the korean war,0,0,1,0,0,0,1
siamese,0,0,1,0,0,0,1
auburn university,0,0,1,0,0,0,1
ashton,0,0,1,0,0,0,1
amos,0,0,1,0,0,0,1
templeton,0,0,1,0,0,0,1
north korean,0,0,1,0,0,0,1
chauhan,0,0,1,0,0,0,1
bliss,0,0,1,0,0,0,1
forgiving,0,0,1,0,0,0,1
magnanimity,0,0,1,0,0,0,1
dhadkan,0,0,1,0,0,0,1
sensibility,0,0,1,0,0,0,1
sheetal,0,0,1,0,0,0,1
bandya,0,0,1,0,0,0,1
assures,0,0,1,0,0,0,1
using,0,0,1,0,0,0,1
illegaly,0,0,1,0,0,0,1
catholic poles,1,0,0,0,0,0,1
hitherto,0,0,1,0,0,0,1
gunda,0,0,1,0,0,0,1
jhappi,0,0,1,0,0,0,1
interacts,0,0,1,0,0,0,1
rustam,0,0,1,0,0,0,1
quotation,1,0,0,0,0,0,1
south asia,0,0,1,0,0,0,1
asthana,0,0,1,0,0,0,1
the night fury,0,0,1,0,0,0,1
charitable,0,0,1,0,0,0,1
ki,0,0,1,0,0,0,1
pavri,0,0,1,0,0,0,1
m.b.b.s.,0,0,1,0,0,0,1
regimen,0,0,1,0,0,0,1
miya,0,0,1,0,0,0,1
retirement &mdash,0,0,1,0,0,0,1
jeffrey,0,0,1,0,0,0,1
persian,0,0,1,0,0,0,1
dude,0,0,1,0,0,0,1
upbringing,0,0,1,0,0,0,1
porn,0,0,1,0,0,0,1
nymphomaniac,0,0,1,0,0,0,1
starlet,0,0,1,0,0,0,1
ringer,0,0,1,0,0,0,1
malibu,0,0,1,0,0,0,1
nihilist,0,0,1,0,0,0,1
underwear,0,0,1,0,0,0,1
embezzlement,0,0,1,0,0,0,1
sportscar,0,0,1,0,0,0,1
bowling,0,0,1,0,0,0,1
maude,0,0,1,0,0,0,1
treehorn,0,0,1,0,0,0,1
sellers,0,0,1,0,0,0,1
teammate,0,0,1,0,0,0,1
the big lebowski's,0,0,1,0,0,0,1
munna,0,0,1,0,0,0,1
chinki,0,0,1,0,0,0,1
emphasis,0,0,1,0,0,0,1
neglect,0,0,1,0,0,0,1
giganticus,0,0,1,0,0,0,1
astrid,0,0,1,0,0,0,1
dragons,0,0,1,0,0,0,1
glade,0,0,1,0,0,0,1
gobber,0,0,1,0,0,0,1
stoick,0,0,1,0,0,0,1
toothless,0,0,1,0,0,0,1
monstrous,0,0,1,0,0,0,1
berk,0,0,1,0,0,0,1
vikings,0,0,1,0,0,0,1
hiccup,0,0,1,0,0,0,1
judenrat,1,0,0,0,0,0,1
a monstrous nightmare,0,0,1,0,0,0,1
schindler,1,0,0,0,0,0,1
neeson,1,0,0,0,0,0,1
pupil,0,0,1,0,0,0,1
andergast,0,0,1,0,0,0,1
cartesian,0,0,1,0,0,0,1
charlotte andergast,0,0,1,0,0,0,1
tidings,0,0,1,0,0,0,1
bachhon,0,0,1,0,0,0,1
the imperial institute of medical sciences,0,0,1,0,0,0,1
munnabhai,0,0,1,0,0,0,1
ashthana,0,0,1,0,0,0,1
sciences,0,0,1,0,0,0,1
faux,0,0,1,0,0,0,1
reinhard,1,0,0,0,0,0,1
asia,0,0,1,0,0,0,1
humiliates,0,0,1,0,0,0,1
the medical college &mdash,0,0,1,0,0,0,1
biwi,0,0,1,0,0,0,1
murli,0,0,1,0,0,0,1
krakow,1,0,0,0,0,0,1
viktor,0,0,1,0,0,0,1
the big lebowski,0,0,1,0,0,0,1
lebowski,0,0,1,0,0,0,1
the persian gulf war,0,0,1,0,0,0,1
scarefloor,0,0,1,0,0,0,1
dakshin,0,0,1,0,0,0,1
vasanta,0,0,1,0,0,0,1
nymph,0,0,1,0,0,0,1
naughty,0,0,1,0,0,0,1
immortality,0,0,1,0,0,0,1
brahmananda,0,0,1,0,0,0,1
mattepa,0,0,1,0,0,0,1
swayamvara,0,0,1,0,0,0,1
kotala,0,0,1,0,0,0,1
bhairavudu,0,0,1,0,0,0,1
vasudhara,0,0,1,0,0,0,1
the bhairava dweepa,0,0,1,0,0,0,1
chandraprabha dynasty,0,0,1,0,0,0,1
sata,0,0,1,0,0,0,1
handsomeness,0,0,1,0,0,0,1
moravia,1,0,0,0,0,0,1
chameleon,0,0,1,0,0,0,1
hurdes,0,0,1,0,0,0,1
scarers,0,0,1,0,0,0,1
goeth,1,0,0,0,0,0,1
hillbilly,0,0,1,0,0,0,1
months,0,0,1,0,0,0,1
the scream extractor,0,0,1,0,0,0,1
the children detection agency,0,0,1,0,0,0,1
monstropolis,0,0,1,0,0,0,1
wazowski,0,0,1,0,0,0,1
dragoon,1,0,0,0,0,0,1
kit,1,0,0,0,0,0,1
workload,0,0,1,0,0,0,1
nazi party,1,0,0,0,0,0,1
boggs,0,0,1,0,0,0,1
cda,0,0,1,0,0,0,1
kingsley,1,0,0,0,0,0,1
roz,0,0,1,0,0,0,1
sudhakar,0,0,1,0,0,0,1
kartikeya dynasty,0,0,1,0,0,0,1
instigation,0,0,1,0,0,0,1
kshudra,0,0,1,0,0,0,1
mattepa sastri,0,0,1,0,0,0,1
lilliputs,0,0,1,0,0,0,1
plead,0,0,1,0,0,0,1
tuumburadeva,0,0,1,0,0,0,1
uttar,0,0,1,0,0,0,1
jamadagni,0,0,1,0,0,0,1
loka,0,0,1,0,0,0,1
thence,0,0,1,0,0,0,1
vanam,0,0,1,0,0,0,1
sculpture,0,0,1,0,0,0,1
padmani,0,0,1,0,0,0,1
subhaleka,0,0,1,0,0,0,1
the island of bhairava,0,0,1,0,0,0,1
ashram,0,0,1,0,0,0,1
kartikeya,0,0,1,0,0,0,1
bhairva,0,0,1,0,0,0,1
jayachandra,0,0,1,0,0,0,1
lilliput,0,0,1,0,0,0,1
yakshini,0,0,1,0,0,0,1
the chandraprabha dynasty,0,0,1,0,0,0,1
giri,0,0,1,0,0,0,1
chandraprabha,0,0,1,0,0,0,1
kona,0,0,1,0,0,0,1
hermitage,0,0,1,0,0,0,1
cot,0,0,1,0,0,0,1
sastri,0,0,1,0,0,0,1
dweepa,0,0,1,0,0,0,1
jamadagni ashram vijay,0,0,1,0,0,0,1
bhairava,0,0,1,0,0,0,1
kshudrapuja,0,0,1,0,0,0,1
sorcery,0,0,1,0,0,0,1
cyclone,0,0,1,0,0,0,1
kondanna,0,0,1,0,0,0,1
jamadagni ashram,0,0,1,0,0,0,1
seadragonus,0,0,1,0,0,0,1
vast,0,0,1,0,0,0,1
raheel,0,0,1,0,0,0,1
afrodita,0,0,1,0,0,0,1
dadan,0,0,1,0,0,0,1
itzhak,1,0,0,0,0,0,1
diarrhea,0,0,1,0,0,0,1
bulgaria,0,0,1,0,0,0,1
harem,0,0,1,0,0,0,1
outhouse,0,0,1,0,0,0,1
matko,0,0,1,0,0,0,1
catering,0,0,1,0,0,0,1
lajjo,0,0,1,0,0,0,1
fistful,0,0,1,0,0,0,1
grga,0,0,1,0,0,0,1
bulgarian,0,0,1,0,0,0,1
destanov,0,0,1,0,0,0,1
pingalan,0,0,1,0,0,0,1
veerabagu,0,0,1,0,0,0,1
alikes,0,0,1,0,0,0,1
juggle,0,0,1,0,0,0,1
accordion,0,0,1,0,0,0,1
peg,0,0,1,0,0,0,1
the danube river,0,0,1,0,0,0,1
politeness,0,0,1,0,0,0,1
parvathy,0,0,1,0,0,0,1
sumathi,0,0,1,0,0,0,1
bangle,0,0,1,0,0,0,1
doer,0,0,1,0,0,0,1
zarije destanov,0,0,1,0,0,0,1
zarije,0,0,1,0,0,0,1
zare,0,0,1,0,0,0,1
sujka,0,0,1,0,0,0,1
barmaid,0,0,1,0,0,0,1
riverboat,0,0,1,0,0,0,1
pitić,0,0,1,0,0,0,1
roma,0,0,1,0,0,0,1
veliki,0,0,1,0,0,0,1
slate,0,0,1,0,0,0,1
karmegam,0,0,1,0,0,0,1
reform,0,0,1,0,0,0,1
protester,0,0,1,0,0,0,1
namelessons,0,0,1,0,0,0,1
kony,0,0,1,0,0,0,1
stigma,0,0,1,0,0,0,1
kony|urlhttp://www.pragoti.in/|accessdate=11,0,0,1,0,0,0,1
bengal,0,0,1,0,0,0,1
khidda,0,0,1,0,0,0,1
bengal swimming,0,0,1,0,0,0,1
the national swimming championship,0,0,1,0,0,0,1
aayushi,0,0,1,0,0,0,1
dafol,0,0,1,0,0,0,1
bachu,0,0,1,0,0,0,1
kaivan,0,0,1,0,0,0,1
ishwar,0,0,1,0,0,0,1
chainani,0,0,1,0,0,0,1
harish,0,0,1,0,0,0,1
sponsorship,0,0,1,0,0,0,1
roadblock,0,0,1,0,0,0,1
naganathapuram,0,0,1,0,0,0,1
ratnapuri,0,0,1,0,0,0,1
marthandan,0,0,1,0,0,0,1
monarchy,0,0,1,0,0,0,1
uplift,0,0,1,0,0,0,1
ancestry,0,0,1,0,0,0,1
erstwhile,0,0,1,0,0,0,1
bhoopathi,0,0,1,0,0,0,1
veerangan,0,0,1,0,0,0,1
monarchist,0,0,1,0,0,0,1
manohari,0,0,1,0,0,0,1
the imperial council,0,0,1,0,0,0,1
upheaval,0,0,1,0,0,0,1
rescuing,0,0,1,0,0,0,1
madana,0,0,1,0,0,0,1
proclamation,0,0,1,0,0,0,1
persuade,0,0,1,0,0,0,1
swoon,0,0,1,0,0,0,1
installment,0,0,1,0,0,0,1
fuss,0,0,1,0,0,0,1
headmaster,0,0,1,0,0,0,1
chutki,0,0,1,0,0,0,1
ajit,0,0,1,0,0,0,1
baldev,0,0,1,0,0,0,1
taji,0,0,1,0,0,0,1
brooch,0,0,1,0,0,0,1
savak,0,0,1,0,0,0,1
reza,0,0,1,0,0,0,1
satrapi,0,0,1,0,0,0,1
shah,0,0,1,0,0,0,1
markus,0,0,1,0,0,0,1
forum,0,0,1,0,0,0,1
marji,0,0,1,0,0,0,1
paris-orly airport,0,0,1,0,0,0,1
dissident,0,0,1,0,0,0,1
zwittau,1,0,0,0,0,0,1
anoush,0,0,1,0,0,0,1
news&nbsp,0,0,1,0,0,0,1
parenting,0,0,1,0,0,0,1
die,0,0,1,0,0,0,1
friends&nbsp,0,0,1,0,0,0,1
simran&nbsp,0,0,1,0,0,0,1
ago&nbsp,0,0,1,0,0,0,1
karva chaud,0,0,1,0,0,0,1
charming,0,0,1,0,0,0,1
eurorail,0,0,1,0,0,0,1
karva,0,0,1,0,0,0,1
eurail,0,0,1,0,0,0,1
chaud,0,0,1,0,0,0,1
journey&nbsp,0,0,1,0,0,0,1
irritation,0,0,1,0,0,0,1
kuljeet,0,0,1,0,0,0,1
arragonce,0,0,1,0,0,0,1
marketer,1,0,0,0,0,0,1
raj&nbsp,0,0,1,0,0,0,1
away&nbsp,0,0,1,0,0,0,1
fundamentalists,0,0,1,0,0,0,1
talmudic,1,0,0,0,0,0,1
bama,0,0,1,0,0,0,1
khamenei,0,0,1,0,0,0,1
sexist,0,0,1,0,0,0,1
islamic,0,0,1,0,0,0,1
alikhan,0,0,1,0,0,0,1
mansoor,0,0,1,0,0,0,1
gouthami,0,0,1,0,0,0,1
yuvarani,0,0,1,0,0,0,1
headman,0,0,1,0,0,0,1
maheswaran,0,0,1,0,0,0,1
stuff,0,0,1,0,0,0,1
16th,0,0,1,0,0,0,1
ethiraj,0,0,1,0,0,0,1
maheshwaran,0,0,1,0,0,0,1
sofa,0,0,1,0,0,0,1
bother,0,0,1,0,0,0,1
seetha,0,0,1,0,0,0,1
poles,1,0,0,0,0,0,1
emulator,0,0,1,0,0,0,1
herr,1,0,0,0,0,0,1
khomeini,0,0,1,0,0,0,1
marjane,0,0,1,0,0,0,1
celebrates,0,0,1,0,0,0,1
fine,0,0,1,0,0,0,1
płaszów,1,0,0,0,0,0,1
nationality,0,0,1,0,0,0,1
communists,0,0,1,0,0,0,1
iranian,0,0,1,0,0,0,1
schloss,0,0,1,0,0,0,1
debonair,0,0,1,0,0,0,1
azerbaijan people's government,0,0,1,0,0,0,1
scrutiny,0,0,1,0,0,0,1
brinnlitz,1,0,0,0,0,0,1
lycée,0,0,1,0,0,0,1
ak-47,0,0,1,0,0,0,1
sabbath,1,0,0,0,0,0,1
duh,0,0,1,0,0,0,1
torment,0,0,1,0,0,0,1
sulley defeat randall,0,0,1,0,0,0,1
bebop;,0,0,0,1,0,0,1
eliot,0,0,0,1,0,0,1
counterweight,0,0,0,1,0,0,1
schaefer,0,0,0,1,0,0,1
mystifies,0,0,0,1,0,0,1
pitch,0,0,0,1,0,0,1
jorge,0,0,0,1,0,0,1
consigliere,1,0,0,0,0,0,1
pathogen,0,0,0,1,0,0,1
shep,0,0,0,1,0,0,1
electra,0,0,0,1,0,0,1
bebop,0,0,0,1,0,0,1
faye,0,0,0,1,0,0,1
volaju,0,0,0,1,0,0,1
woolong,0,0,0,1,0,0,1
ein,0,0,0,1,0,0,1
crusade,0,0,0,1,0,0,1
blain,0,0,0,1,0,0,1
sends,0,0,0,1,0,0,1
army special forces,0,0,0,1,0,0,1
weaponry,0,0,0,1,0,0,1
soccer,0,0,0,1,0,0,1
darkwood,0,0,0,1,0,0,1
octave,0,0,0,1,0,0,1
daft,0,0,0,1,0,0,1
daft club,0,0,0,1,0,0,1
the crescendolls,0,0,0,1,0,0,1
veridis,0,0,0,1,0,0,1
darkwood manor,0,0,0,1,0,0,1
vinyl,0,0,0,1,0,0,1
stun,0,0,0,1,0,0,1
crescendolls,0,0,0,1,0,0,1
jettisons,0,0,0,1,0,0,1
sole,0,0,0,1,0,0,1
imaging,0,0,0,1,0,0,1
dillon,0,0,0,1,0,0,1
biologist,0,0,0,1,0,0,1
harvard,0,0,0,1,0,0,1
pun,0,0,0,1,0,0,1
changer,0,0,0,1,0,0,1
epa,0,0,0,1,0,0,1
stantz,0,0,0,1,0,0,1
egon,0,0,0,1,0,0,1
marshmallow,0,0,0,1,0,0,1
proton,0,0,0,1,0,0,1
vinz,0,0,0,1,0,0,1
columbia university,0,0,0,1,0,0,1
spengler,0,0,0,1,0,0,1
exterminator,0,0,0,1,0,0,1
gozer,0,0,0,1,0,0,1
zeddemore,0,0,0,1,0,0,1
gateway,0,0,0,1,0,0,1
barrett,0,0,0,1,0,0,1
goo,0,0,0,1,0,0,1
keymaster,0,0,0,1,0,0,1
demigod,0,0,0,1,0,0,1
dana,0,0,0,1,0,0,1
paley,0,0,0,1,0,0,1
tully,0,0,0,1,0,0,1
partee,0,0,0,1,0,0,1
babylonian,0,0,0,1,0,0,1
anthropologist,0,0,0,1,0,0,1
gautama,0,0,0,1,0,0,1
hypothetical,0,0,0,1,0,0,1
oldman,0,0,0,1,0,0,1
chemistry,0,0,0,1,0,0,1
prehistory,0,0,0,1,0,0,1
hammurabi,0,0,0,1,0,0,1
gogh,0,0,0,1,0,0,1
tattaglias,1,0,0,0,0,0,1
ashen,0,0,0,1,0,0,1
world war i.,0,0,0,1,0,0,1
dana/zuul's,0,0,0,1,0,0,1
shandor,0,0,0,1,0,0,1
remix,0,0,0,1,0,0,1
wormhole,0,0,0,1,0,0,1
rolling,0,0,1,0,0,0,1
robau,0,0,0,1,0,0,1
starfleet academy,0,0,0,1,0,0,1
"sarek, spock",0,0,0,1,0,0,1
|titlecargill,0,0,0,1,0,0,1
christening,1,0,0,0,0,0,1
ref,0,0,0,1,0,0,1
drilling,0,0,0,1,0,0,1
kelvins,0,0,0,1,0,0,1
perimeter,0,0,0,1,0,0,1
baryl,0,0,0,1,0,0,1
grayson,0,0,0,1,0,0,1
|first2009,0,0,0,1,0,0,1
romulus,0,0,0,1,0,0,1
cease,0,0,0,1,0,0,1
namehttp://blogs.discovermagazine.com/badastronomy/2009/05/08/ba-review-star-trek,0,0,0,1,0,0,1
sarek,0,0,0,1,0,0,1
kirk and spock,0,0,0,1,0,0,1
telekinesis,0,0,0,1,0,0,1
gertie,0,0,0,1,0,0,1
keys,0,0,0,1,0,0,1
pieces,0,0,0,1,0,0,1
sway,1,0,0,0,0,0,1
dowser,0,0,0,1,0,0,1
layton,0,0,0,1,0,0,1
spoor,0,0,0,1,0,0,1
duct,0,0,0,1,0,0,1
admirer,0,0,0,1,0,0,1
buttles,0,0,0,1,0,0,1
jaffe,0,0,0,1,0,0,1
brazil,0,0,0,1,0,0,1
e.t.,0,0,0,1,0,0,1
dissection,0,0,0,1,0,0,1
quiet,0,0,0,1,0,0,1
toolshed,0,0,0,1,0,0,1
speak & spell,0,0,0,1,0,0,1
o'hara,0,0,0,1,0,0,1
=,0,0,0,1,0,0,1
kobayashi maru,0,0,0,1,0,0,1
publishing|accessdate,0,0,0,1,0,0,1
vulcans,0,0,0,1,0,0,1
conspire,0,0,0,1,0,0,1
waldman,0,0,0,1,0,0,1
operating,0,0,0,1,0,0,1
moritz,0,0,0,1,0,0,1
lavenza,0,0,0,1,0,0,1
searcher,0,0,0,1,0,0,1
vane,0,0,0,1,0,0,1
enforcer,1,0,0,0,0,0,1
censorship,0,0,0,1,0,0,1
boles,0,0,0,1,0,0,1
arpegius,0,0,0,1,0,0,1
daft punk,0,0,0,1,0,0,1
matsumoto,0,0,0,1,0,0,1
marketing,0,0,0,1,0,0,1
aerodynamic,0,0,0,1,0,0,1
crackling,0,0,0,1,0,0,1
|titleplait,0,0,0,1,0,0,1
amanda,0,0,0,1,0,0,1
08|workkalmbach,0,0,0,1,0,0,1
narada{{'}}s,0,0,0,1,0,0,1
vulcan science academy,0,0,0,1,0,0,1
kelvin{{'}}s,0,0,0,1,0,0,1
winona,0,0,0,1,0,0,1
namehttp://www.cnn.com/2009/showbiz/movies/05/08/the.scene.star.trek/index.html#cnnstctext,0,0,0,1,0,0,1
romulan,0,0,0,1,0,0,1
personnel,0,0,0,1,0,0,1
shuttlecraft,0,0,0,1,0,0,1
rear admiral,0,0,0,1,0,0,1
nero,0,0,0,1,0,0,1
maru,0,0,0,1,0,0,1
families,1,0,0,0,0,0,1
ayel,0,0,0,1,0,0,1
stardate,0,0,0,1,0,0,1
kobayashi,0,0,0,1,0,0,1
ivo,0,0,0,1,0,0,1
gozerian,0,0,0,1,0,0,1
puft,0,0,0,1,0,0,1
carew,0,0,0,1,0,0,1
hobson,0,0,0,1,0,0,1
jekyll.,0,0,0,1,0,0,1
muriel,0,0,0,1,0,0,1
poole,0,0,0,1,0,0,1
jekyll,0,0,0,1,0,0,1
danvers,0,0,0,1,0,0,1
"muriel, jekyll",0,0,0,1,0,0,1
lanyon,0,0,0,1,0,0,1
clortho,0,0,0,1,0,0,1
lanyon from jekyll instructing lanyon,0,0,0,1,0,0,1
carews,0,0,0,1,0,0,1
lanyon.,0,0,0,1,0,0,1
garuda,0,0,0,1,0,0,1
gandharva,0,0,0,1,0,0,1
vidhyadhara,0,0,0,1,0,0,1
yaksha,0,0,0,1,0,0,1
hyde,0,0,0,1,0,0,1
exasperated,0,0,0,1,0,0,1
the california medical research institute,0,0,0,1,0,0,1
pound,0,0,0,1,0,0,1
claude,0,0,0,1,0,0,1
gobi,0,0,0,1,0,0,1
slack,0,0,0,1,0,0,1
dollhouse,0,0,0,1,0,0,1
insecticide,0,0,0,1,0,0,1
affliction,0,0,0,1,0,0,1
carey,0,0,0,1,0,0,1
sideshow,0,0,0,1,0,0,1
trend,0,0,0,1,0,0,1
prognosis,0,0,0,1,0,0,1
brasi,1,0,0,0,0,0,1
shrinking,0,0,0,1,0,0,1
rearranging,0,0,0,1,0,0,1
diminution,0,0,0,1,0,0,1
bramson,0,0,0,1,0,0,1
pisacha,0,0,0,1,0,0,1
demi,0,0,0,1,0,0,1
kinnera,0,0,0,1,0,0,1
archeologist,0,0,0,1,0,0,1
godzilla,0,0,0,1,0,0,1
odo island,0,0,0,1,0,0,1
woltz,1,0,0,0,0,0,1
godson,1,0,0,0,0,0,1
newscast,0,0,0,1,0,0,1
kyohei,0,0,0,1,0,0,1
hospitals,0,0,0,1,0,0,1
trilobite,0,0,0,1,0,0,1
surviving,0,0,0,1,0,0,1
volt,0,0,0,1,0,0,1
choirs,0,0,0,1,0,0,1
devastation,0,0,0,1,0,0,1
women,0,0,0,1,0,0,1
post-war,0,0,0,1,0,0,1
łukaszewicz,0,0,0,1,0,0,1
emiko,0,0,0,1,0,0,1
ships,0,0,0,1,0,0,1
rakshasa,0,0,0,1,0,0,1
yamane,0,0,0,1,0,0,1
kimpurusha,0,0,0,1,0,0,1
valikilya,0,0,0,1,0,0,1
vaali.{{cite,0,0,0,1,0,0,1
vanara,0,0,0,1,0,0,1
supremacy,0,0,0,1,0,0,1
asphixiation,0,0,0,1,0,0,1
civilians,0,0,0,1,0,0,1
daisuke,0,0,0,1,0,0,1
hideto ogata,0,0,0,1,0,0,1
odo,0,0,0,1,0,0,1
repercussion,0,0,0,1,0,0,1
ogata,0,0,0,1,0,0,1
serizawa,0,0,0,1,0,0,1
hideto,0,0,0,1,0,0,1
diving,0,0,0,1,0,0,1
curwen,0,0,0,1,0,0,1
sonoran,0,0,0,1,0,0,1
controller,0,0,0,1,0,0,1
marine corps,1,0,0,0,0,0,1
aghor sen & bhootnath nandi,0,0,0,1,0,0,1
kartik,0,0,0,1,0,0,1
aghor,0,0,0,1,0,0,1
nandi,0,0,0,1,0,0,1
brave,0,0,0,1,0,0,1
nischintipur,0,0,0,1,0,0,1
aghar,0,0,0,1,0,0,1
bhootnath,0,0,0,1,0,0,1
subuddhi,0,0,0,1,0,0,1
vik,0,0,0,1,0,0,1
begum,0,0,0,1,0,0,1
seminar,0,0,0,1,0,0,1
nondy,0,0,0,1,0,0,1
bhootnath & karthik,0,0,0,1,0,0,1
the begum & her goons,0,0,0,1,0,0,1
gray's sports almanac,0,0,0,1,0,0,1
old biff's,0,0,0,1,0,0,1
nyapcha,0,0,0,1,0,0,1
almanac,0,0,0,1,0,0,1
whence,0,0,0,1,0,0,1
venkman,0,0,0,1,0,0,1
zuul,0,0,0,1,0,0,1
the sedgewick hotel,0,0,0,1,0,0,1
blueprint,0,0,0,1,0,0,1
gatekeeper,0,0,0,1,0,0,1
destructor,0,0,0,1,0,0,1
ghostbusters,0,0,0,1,0,0,1
briefly,0,0,0,1,0,0,1
possessor,0,0,0,1,0,0,1
sports,0,0,0,1,0,0,1
western union,0,0,0,1,0,0,1
griff,0,0,0,1,0,0,1
enchantment,0,0,0,1,0,0,1
the sea dance,0,0,0,1,0,0,1
mahommadi,0,0,0,1,0,0,1
vik & karthik,0,0,0,1,0,0,1
cotopaxi,0,0,0,1,0,0,1
the sonoran desert,0,0,0,1,0,0,1
moorcroft,0,0,0,1,0,0,1
lacombe,0,0,0,1,0,0,1
tbf,0,0,0,1,0,0,1
mapmaker,0,0,0,1,0,0,1
lineman,0,0,0,1,0,0,1
jillian,0,0,0,1,0,0,1
barry,0,0,0,1,0,0,1
grumman,0,0,0,1,0,0,1
the gobi desert,0,0,0,1,0,0,1
ronnie,0,0,0,1,0,0,1
neary,0,0,0,1,0,0,1
witnesses,0,0,0,1,0,0,1
guiler,0,0,0,1,0,0,1
indianapolis,0,0,0,1,0,0,1
air traffic control,0,0,0,1,0,0,1
laughlin,0,0,0,1,0,0,1
grumman tbf avengers,0,0,0,1,0,0,1
patalghar,0,0,0,1,0,0,1
muncie,0,0,0,1,0,0,1
butterfly,0,0,0,1,0,0,1
phonograph,0,0,0,1,0,0,1
bianca,0,0,0,1,0,0,1
the moon leading him,0,0,0,1,0,0,1
progression,0,0,0,1,0,0,1
diplomacy,0,0,0,1,0,0,1
rocketship,0,0,0,1,0,0,1
münchhausen,0,0,0,1,0,0,1
joey,0,0,0,1,0,0,1
tonik,0,0,0,1,0,0,1
verne,0,0,0,1,0,0,1
cosmonaut,0,0,0,1,0,0,1
spaceman,0,0,0,1,0,0,1
damsel,0,0,0,1,0,0,1
princess bianca,0,0,0,1,0,0,1
buttle,0,0,0,1,0,0,1
lowry,0,0,0,1,0,0,1
emilio,1,0,0,0,0,0,1
meryl,0,0,0,1,0,0,1
erasure,0,0,0,1,0,0,1
lacuna,0,0,0,1,0,0,1
legality,0,0,0,1,0,0,1
unravels,0,0,0,1,0,0,1
seahaven,0,0,0,1,0,0,1
advert,0,0,0,1,0,0,1
apollonia,1,0,0,0,0,0,1
hobo,0,0,0,1,0,0,1
handgun,1,0,0,0,0,0,1
instill,0,0,0,1,0,0,1
forego,1,0,0,0,0,0,1
abnormality,0,0,0,1,0,0,1
marlon,0,0,0,1,0,0,1
reappearance,0,0,0,1,0,0,1
"a ""free truman",0,0,0,1,0,0,1
luca,1,0,0,0,0,0,1
mierzwiak,0,0,0,1,0,0,1
a long island rail road,0,0,0,1,0,0,1
beckons,0,0,0,1,0,0,1
clementine,0,0,0,1,0,0,1
ups,0,0,0,1,0,0,1
deltoid,0,0,0,1,0,0,1
cooperation,0,0,0,1,0,0,1
dim,0,0,0,1,0,0,1
beethoven,0,0,0,1,0,0,1
alex's petty crimes,0,0,0,1,0,0,1
yield,0,0,0,1,0,0,1
homeless,0,0,0,1,0,0,1
"cat""-woman",0,0,0,1,0,0,1
vagrant,0,0,0,1,0,0,1
kruczynski,0,0,0,1,0,0,1
"lacuna, inc.",0,0,0,1,0,0,1
barish,0,0,0,1,0,0,1
joel,0,0,0,1,0,0,1
montauk,0,0,0,1,0,0,1
meltdown,0,0,0,1,0,0,1
truman,0,0,0,1,0,0,1
burbank,0,0,0,1,0,0,1
stalker,0,0,0,1,0,0,1
porcupine,0,0,0,1,0,0,1
lieutenant general rogard,0,0,0,1,0,0,1
beatnik,0,0,0,1,0,0,1
rogard,0,0,0,1,0,0,1
mccoppin,0,0,0,1,0,0,1
bb,0,0,0,1,0,0,1
maine,0,0,0,1,0,0,1
hogarth,0,0,0,1,0,0,1
investigate,0,0,0,1,0,0,1
hughes,0,0,0,1,0,0,1
beeping,0,0,0,1,0,0,1
rockwell,0,0,0,1,0,0,1
substation,0,0,0,1,0,0,1
sdm,0,0,0,1,0,0,1
barn,0,0,0,1,0,0,1
nobel,0,0,0,1,0,0,1
tyutchev,0,0,0,1,0,0,1
catchphrase,0,0,0,1,0,0,1
blockade,0,0,0,1,0,0,1
travelling,0,0,0,1,0,0,1
christof,0,0,0,1,0,0,1
spotlight,0,0,0,1,0,0,1
viewership,0,0,0,1,0,0,1
the palais de chaillot,0,0,0,1,0,0,1
palais,0,0,0,1,0,0,1
experimenter,0,0,0,1,0,0,1
the third world war,0,0,0,1,0,0,1
jetty,0,0,0,1,0,0,1
salvatore,1,0,0,0,0,0,1
chaillot,0,0,0,1,0,0,1
fontane,1,0,0,0,0,0,1
fyodor tyutchev,0,0,0,1,0,0,1
antechamber,0,0,0,1,0,0,1
exertion,0,0,0,1,0,0,1
ludwig,0,0,0,1,0,0,1
billyboy,0,0,0,1,0,0,1
totalitarianism,0,0,0,1,0,0,1
murderess,0,0,1,0,0,0,1
grappling,0,0,0,1,0,0,1
mu/th/ur,0,0,0,1,0,0,1
fantastic,0,0,0,1,0,0,1
abbreviation,0,0,0,1,0,0,1
videodisk,0,0,0,1,0,0,1
quadrilogy,0,0,0,1,0,0,1
subhadra,1,0,0,0,0,0,1
engineers,0,0,0,1,0,0,1
auriga,0,0,0,1,0,0,1
fantastic films,0,0,0,1,0,0,1
ore,0,0,0,1,0,0,1
mu/th/ur 6000,0,0,0,1,0,0,1
films,0,0,0,1,0,0,1
lambert,0,0,0,1,0,0,1
th,0,0,0,1,0,0,1
planetoid,0,0,0,1,0,0,1
ježková,0,0,1,0,0,0,1
mineral,0,0,0,1,0,0,1
the institute for the blind,0,0,1,0,0,0,1
lowdown,0,0,1,0,0,0,1
hatpin,0,0,1,0,0,0,1
poise,0,0,1,0,0,0,1
scrape,0,0,1,0,0,0,1
aarti,0,0,1,0,0,0,1
j.k.,0,0,1,0,0,0,1
imago,0,0,1,0,0,0,1
cvalda,0,0,1,0,0,0,1
houston,0,0,1,0,0,0,1
allu,1,0,0,0,0,0,1
accompaniment,0,0,1,0,0,0,1
brenda,0,0,1,0,0,0,1
selma,0,0,1,0,0,0,1
ježek,0,0,1,0,0,0,1
björk,0,0,1,0,0,0,1
ur,0,0,0,1,0,0,1
retinue,1,0,0,0,0,0,1
equality,0,0,0,1,0,0,1
hovercar,0,0,0,1,0,0,1
magee,0,0,0,1,0,0,1
symphony,0,0,0,1,0,0,1
restitution,0,0,0,1,0,0,1
aranyavasa,1,0,0,0,0,0,1
stereo,0,0,0,1,0,0,1
kubrick,0,0,0,1,0,0,1
duryodhana,1,0,0,0,0,0,1
decaying,0,0,0,1,0,0,1
burgess,0,0,0,1,0,0,1
ninth symphony,0,0,0,1,0,0,1
canal,0,0,0,1,0,0,1
droogs,0,0,0,1,0,0,1
ninth,0,0,0,1,0,0,1
aversion,0,0,0,1,0,0,1
manservant,0,0,0,1,0,0,1
abhimanyu,1,0,0,0,0,0,1
washer,0,0,0,1,0,0,1
mcintee,0,0,0,1,0,0,1
pm,0,0,0,1,0,0,1
extinguisher,0,0,0,1,0,0,1
bridegroom,1,0,0,0,0,0,1
thedus,0,0,0,1,0,0,1
lakshmana,1,0,0,0,0,0,1
decompression,0,0,0,1,0,0,1
prod,0,0,0,1,0,0,1
mu,0,0,0,1,0,0,1
wiring,0,0,0,1,0,0,1
balarama,1,0,0,0,0,0,1
detailer,0,0,0,1,0,0,1
gigawatts,0,0,0,1,0,0,1
baines,0,0,0,1,0,0,1
dmc-12,0,0,0,1,0,0,1
libyan,0,0,0,1,0,0,1
plutonium,0,0,0,1,0,0,1
mansley,0,0,0,1,0,0,1
glacier,0,0,0,1,0,0,1
retrieval,0,0,0,1,0,0,1
stallion,1,0,0,0,0,0,1
akira,0,0,0,1,0,0,1
bōsōzoku,0,0,0,1,0,0,1
requirement,0,0,0,1,0,0,1
canister,0,0,0,1,0,0,1
capsules,0,0,0,1,0,0,1
masaru,0,0,0,1,0,0,1
neo-tokyo's,0,0,0,1,0,0,1
kiyoko,0,0,0,1,0,0,1
langjökull,0,0,0,1,0,0,1
yamagata,0,0,0,1,0,0,1
clowns,0,0,0,1,0,0,1
engulfs,0,0,0,1,0,0,1
tetsuo,0,0,0,1,0,0,1
kaneda,0,0,0,1,0,0,1
shikishima,0,0,0,1,0,0,1
kei,0,0,0,1,0,0,1
esper,0,0,0,1,0,0,1
neo-tokyo,0,0,0,1,0,0,1
shotaro kaneda,0,0,0,1,0,0,1
onishi,0,0,0,1,0,0,1
nausicaä,0,0,0,1,0,0,1
topsoil,0,0,0,1,0,0,1
asbel,0,0,0,1,0,0,1
ohmu,0,0,0,1,0,0,1
ohmus,0,0,0,1,0,0,1
pejites,0,0,0,1,0,0,1
tolmekia,0,0,0,1,0,0,1
investment,1,0,0,0,0,0,1
the giant warrior,0,0,0,1,0,0,1
glider,0,0,0,1,0,0,1
giant warrior,0,0,0,1,0,0,1
invading,0,0,0,1,0,0,1
kushana,0,0,0,1,0,0,1
tolmekians,0,0,0,1,0,0,1
migraine,0,0,0,1,0,0,1
espers,0,0,0,1,0,0,1
kaori,0,0,0,1,0,0,1
shotaro,0,0,0,1,0,0,1
kris,0,0,0,1,0,0,1
snaut,0,0,0,1,0,0,1
g.o.r.a.,0,0,0,1,0,0,1
logar,0,0,0,1,0,0,1
tuttle,0,0,0,1,0,0,1
declare,0,0,0,1,0,0,1
information retrieval,0,0,0,1,0,0,1
ndash,0,0,0,1,0,0,1
conditioning,0,0,0,1,0,0,1
services,0,0,0,1,0,0,1
renegade,0,0,0,1,0,0,1
lint,0,0,0,1,0,0,1
central services,0,0,0,1,0,0,1
khaki,1,0,0,0,0,0,1
ambition &ndash,0,0,0,1,0,0,1
garrotte,1,0,0,0,0,0,1
lakeside,0,0,0,1,0,0,1
solaris,0,0,0,1,0,0,1
shima,0,0,0,1,0,0,1
construct,0,0,0,1,0,0,1
cooperates,0,0,0,1,0,0,1
kai,0,0,0,1,0,0,1
flask,0,0,0,1,0,0,1
the revolutionary group,0,0,0,1,0,0,1
henri,0,0,0,1,0,0,1
tattaglia,1,0,0,0,0,0,1
keepsake,0,0,0,1,0,0,1
brainwave,0,0,0,1,0,0,1
berton,0,0,0,1,0,0,1
neutrino,0,0,0,1,0,0,1
volume,0,0,0,1,0,0,1
haris,0,0,0,1,0,0,1
symposium,0,0,0,1,0,0,1
sartorius,0,0,0,1,0,0,1
gibarian,0,0,0,1,0,0,1
lastelle,0,0,0,1,0,0,1
ipac,0,0,0,1,0,0,1
tolmekian,0,0,0,1,0,0,1
kemp,0,0,0,1,0,0,1
pretension,0,0,0,1,0,0,1
bulging,0,0,0,1,0,0,1
steen,0,0,0,1,0,0,1
eyepatch,0,0,0,1,0,0,1
creaky,0,0,0,1,0,0,1
violin,0,0,0,1,0,0,1
puttin,0,0,0,1,0,0,1
normal,0,0,0,1,0,0,1
inga,0,0,0,1,0,0,1
monotone,0,0,0,1,0,0,1
ritz,0,0,0,1,0,0,1
switch,0,0,0,1,0,0,1
monocle,0,0,0,1,0,0,1
flattery,0,0,0,1,0,0,1
fronk,0,0,0,1,0,0,1
abby,0,0,0,1,0,0,1
haruhi,0,0,0,1,0,0,1
blücher,0,0,0,1,0,0,1
brigade,0,0,0,1,0,0,1
the sos brigade,0,0,0,1,0,0,1
nagato,0,0,0,1,0,0,1
anime,0,0,0,1,0,0,1
tanabata,0,0,0,1,0,0,1
sos,0,0,0,1,0,0,1
taniguchi,0,0,0,1,0,0,1
asahina,0,0,0,1,0,0,1
koizumi,0,0,0,1,0,0,1
suzumiya,0,0,0,1,0,0,1
asakura,0,0,0,1,0,0,1
itsuki,0,0,0,1,0,0,1
integration,0,0,0,1,0,0,1
the data integration thought entity,0,0,0,1,0,0,1
kyon,0,0,0,1,0,0,1
mikuru,0,0,0,1,0,0,1
igor,0,0,0,1,0,0,1
mccluskey,1,0,0,0,0,0,1
kurotowa,0,0,0,1,0,0,1
emission,0,0,0,1,0,0,1
chitauri,0,0,0,1,0,0,1
physicist,0,0,0,1,0,0,1
"rogers, stark",0,0,0,1,0,0,1
coulson,0,0,0,1,0,0,1
clint,0,0,0,1,0,0,1
conjunction,0,0,0,1,0,0,1
hulk,0,0,0,1,0,0,1
confers,0,0,0,1,0,0,1
invader,0,0,0,1,0,0,1
selvig,0,0,0,1,0,0,1
stark,0,0,0,1,0,0,1
thor,0,0,0,1,0,0,1
asgardian,0,0,0,1,0,0,1
toxic,0,0,0,1,0,0,1
pejite,0,0,0,1,0,0,1
asgard,0,0,0,1,0,0,1
stuttgart,0,0,0,1,0,0,1
matters,0,0,0,1,0,0,1
natasha,0,0,0,1,0,0,1
explodes,0,0,0,1,0,0,1
vitelli,1,0,0,0,0,0,1
loki,0,0,0,1,0,0,1
scepter,0,0,0,1,0,0,1
tesseract,0,0,0,1,0,0,1
iridium,0,0,0,1,0,0,1
helicarrier,0,0,0,1,0,0,1
master{{ref,0,0,0,1,0,0,1
terrestrials,0,0,0,1,0,0,1
initiative,0,0,0,1,0,0,1
s.h.i.e.l.d.,0,0,0,1,0,0,1
the asgardian loki,0,0,0,1,0,0,1
shawarma,0,0,0,1,0,0,1
romanoff,0,0,0,1,0,0,1
gamma,0,0,0,1,0,0,1
chairman,0,0,1,0,0,0,1
kraków,1,0,0,0,0,0,1
scoutmaster sowah,0,1,0,0,0,0,1
parallel,0,0,1,0,0,0,1
monosoft,0,0,1,0,0,0,1
known,0,0,1,0,0,0,1
economy,0,0,1,0,0,0,1
artwork,0,0,1,0,0,0,1
mohn,0,0,1,0,0,0,1
the cold war,0,0,1,0,0,0,1
y.,0,0,1,0,0,0,1
andrea,0,0,1,0,0,0,1
loeb,1,0,0,0,0,0,1
his,0,0,1,0,0,0,1
garcia,1,0,0,0,0,0,1
/,0,0,1,0,0,0,1
entrapment,0,0,1,0,0,0,1
intra,0,0,1,0,0,0,1
disposition,0,0,1,0,0,0,1
pinnacle,0,0,1,0,0,0,1
wilber,0,0,1,0,0,0,1
finder,0,0,1,0,0,0,1
froggy,0,0,1,0,0,0,1
maroni,1,0,0,0,0,0,1
batpod,1,0,0,0,0,0,1
toddy,0,0,1,0,0,0,1
remembrance,0,0,1,0,0,0,1
preetham,0,0,1,0,0,0,1
devadas,0,0,1,0,0,0,1
jaanu,0,0,1,0,0,0,1
manhole,0,0,1,0,0,0,1
reject,0,0,1,0,0,0,1
gautham,0,0,1,0,0,0,1
nandini,0,0,1,0,0,0,1
madikeri,0,0,1,0,0,0,1
the bat-signal,1,0,0,0,0,0,1
tregoweth,0,0,1,0,0,0,1
the j. c. wilber building,0,0,1,0,0,0,1
cornerstone,0,0,1,0,0,0,1
absolutism,0,0,1,0,0,0,1
euphoria,0,0,1,0,0,0,1
watershed,0,0,1,0,0,0,1
eccentric,0,0,1,0,0,0,1
poulain,0,0,1,0,0,0,1
gnome,0,0,1,0,0,0,1
dufayel,0,0,1,0,0,0,1
amélie,0,0,1,0,0,0,1
reconciliatory,0,0,1,0,0,0,1
moulins,0,0,1,0,0,0,1
quincampoix,0,0,1,0,0,0,1
the boating party,0,0,1,0,0,0,1
greengrocer,0,0,1,0,0,0,1
lucien,0,0,1,0,0,0,1
woody's,0,0,1,0,0,0,1
dumpster,0,0,1,0,0,0,1
cctv,0,0,1,0,0,0,1
diversion,0,0,1,0,0,0,1
o'-huggin,0,0,1,0,0,0,1
renoir,0,0,1,0,0,0,1
pierre-auguste renoir,0,0,1,0,0,0,1
rationalism,0,0,1,0,0,0,1
luncheon,0,0,1,0,0,0,1
gurukul,0,0,1,0,0,0,1
satyapriya,0,0,1,0,0,0,1
inequality,0,0,1,0,0,0,1
inter,0,0,1,0,0,0,1
sanyal,0,0,1,0,0,0,1
rupture,0,0,1,0,0,0,1
ranjana,0,0,1,0,0,0,1
bengali,0,0,1,0,0,0,1
relativism,0,0,1,0,0,0,1
shyness,0,0,1,0,0,0,1
collignon,0,0,1,0,0,0,1
matchmaker,0,0,1,0,0,0,1
montmartre,0,0,1,0,0,0,1
landmark,0,0,1,0,0,0,1
amelie,0,0,1,0,0,0,1
preetam,0,0,1,0,0,0,1
subbayya,0,0,1,0,0,0,1
herder,0,0,1,0,0,0,1
tomainia,0,0,1,0,0,0,1
srivastav,0,0,1,0,0,0,1
deven,0,0,1,0,0,0,1
"lakshman"" & ratna's",0,0,1,0,0,0,1
hockey,0,0,1,0,0,0,1
urmi,0,0,1,0,0,0,1
wearing kurta &,0,0,1,0,0,0,1
financier,0,0,1,0,0,0,1
eidenmuller,0,0,1,0,0,0,1
gotham city,1,0,0,0,0,0,1
vineyard,0,0,1,0,0,0,1
laborer,0,0,1,0,0,0,1
ghetto{{dn,0,0,1,0,0,0,1
the central powers,0,0,1,0,0,0,1
american rhetoric,0,0,1,0,0,0,1
marsh,0,0,1,0,0,0,1
garbitsch,0,0,1,0,0,0,1
skyhook,1,0,0,0,0,0,1
paying,0,0,1,0,0,0,1
hocky,0,0,1,0,0,0,1
bhavani,0,0,1,0,0,0,1
ramprasad,0,0,1,0,0,0,1
hocky test,0,0,1,0,0,0,1
pascal,0,0,1,0,0,0,1
arkham,1,0,0,0,0,0,1
urmila & lucky,0,0,1,0,0,0,1
trait,0,0,1,0,0,0,1
bhavani shankar,0,0,1,0,0,0,1
lakshman,0,0,1,0,0,0,1
urmila,0,0,1,0,0,0,1
kalindi,0,0,1,0,0,0,1
dashrathprasad,0,0,1,0,0,0,1
flip,1,0,0,0,0,0,1
pascal d'costa &,0,0,1,0,0,0,1
ram &,0,0,1,0,0,0,1
bhavani shankar's,0,0,1,0,0,0,1
lohengrin,0,0,1,0,0,0,1
amnesiac,0,0,1,0,0,0,1
might,0,0,1,0,0,0,1
stormtroopers,0,0,1,0,0,0,1
benzino,0,0,1,0,0,0,1
hynkel,0,0,1,0,0,0,1
bacteria,0,0,1,0,0,0,1
reminder,0,0,1,0,0,0,1
pinky,0,0,1,0,0,0,1
tranquility,0,0,1,0,0,0,1
heartbreak,0,0,1,0,0,0,1
minni,0,0,1,0,0,0,1
infedility,0,0,1,0,0,0,1
dk,0,0,1,0,0,0,1
indu,0,0,1,0,0,0,1
reluctance,0,0,1,0,0,0,1
st. joseph's college,0,0,1,0,0,0,1
nainital,0,0,1,0,0,0,1
bhavana,0,0,1,0,0,0,1
osterlich,0,0,1,0,0,0,1
barbershop,0,0,1,0,0,0,1
subjugation,0,0,1,0,0,0,1
kindlier,0,0,1,0,0,0,1
pogrom,0,0,1,0,0,0,1
adenoid,0,0,1,0,0,0,1
reinstates,0,0,1,0,0,0,1
hannah,0,0,1,0,0,0,1
suffers,0,0,1,0,0,0,1
jewry,0,0,1,0,0,0,1
herring,0,0,1,0,0,0,1
joker,1,0,0,0,0,0,1
denounces,0,0,1,0,0,0,1
webcitation,1,0,0,0,0,0,1
the interior garbitsch,0,0,1,0,0,0,1
tomainian,0,0,1,0,0,0,1
throng,0,0,1,0,0,0,1
persecution,0,0,1,0,0,0,1
napaloni,0,0,1,0,0,0,1
filing,0,0,1,0,0,0,1
barbie,0,0,1,0,0,0,1
sunnyside daycare,0,0,1,0,0,0,1
pyaremohan ilahabadi,0,0,1,0,0,0,1
pyaremohan,0,0,1,0,0,0,1
p k srivastava,0,0,1,0,0,0,1
botany,0,0,1,0,0,0,1
ilahabadi,0,0,1,0,0,0,1
grammar,0,0,1,0,0,0,1
p,0,0,1,0,0,0,1
sinha,0,0,1,0,0,0,1
the flying dutchman,0,0,1,0,0,0,1
death.{{cite,1,0,0,0,0,0,1
blancwhat,0,0,1,0,0,0,1
wabbit,0,0,1,0,0,0,1
headdress,0,0,1,0,0,0,1
duet,0,0,1,0,0,0,1
the merrie melodies,0,0,1,0,0,0,1
valkyrie,0,0,1,0,0,0,1
smog,0,0,1,0,0,0,1
irk,0,0,1,0,0,0,1
raghavendra,0,0,1,0,0,0,1
jijaji,0,0,1,0,0,0,1
antithesis,0,0,1,0,0,0,1
pandits,0,0,1,0,0,0,1
togetherness,0,0,1,0,0,0,1
haripat,0,0,1,0,0,0,1
haripad,0,0,1,0,0,0,1
tripathi,0,0,1,0,0,0,1
parimal,0,0,1,0,0,0,1
bhaiyya,0,0,1,0,0,0,1
persistence,0,0,1,0,0,0,1
caporegime,1,0,0,0,0,0,1
sulekha,0,0,1,0,0,0,1
vasudha,0,0,1,0,0,0,1
p k srivastava's,0,0,1,0,0,0,1
chaturvedi,0,0,1,0,0,0,1
lata,0,0,1,0,0,0,1
sukumar,0,0,1,0,0,0,1
merrie,0,0,1,0,0,0,1
qwiet,0,0,1,0,0,0,1
pilgrims,0,0,1,0,0,0,1
dutchman,0,0,1,0,0,0,1
albab,0,0,1,0,0,0,1
tray,0,0,1,0,0,0,1
syawal,0,0,1,0,0,0,1
muharam,0,0,1,0,0,0,1
carmela,1,0,0,0,0,0,1
djinn,0,0,1,0,0,0,1
grump,0,0,1,0,0,0,1
muharram,0,0,1,0,0,0,1
mosque,0,0,1,0,0,0,1
safar,0,0,1,0,0,0,1
mashood,0,0,1,0,0,0,1
the senate committee's,1,0,0,0,0,0,1
ahmad,0,0,1,0,0,0,1
zahara,0,0,1,0,0,0,1
suhara,0,0,1,0,0,0,1
arabic,0,0,1,0,0,0,1
the internet movie database,0,0,1,0,0,0,1
brünnhilde,0,0,1,0,0,0,1
elmer,0,0,1,0,0,0,1
the black hand,1,0,0,0,0,0,1
mel,0,0,1,0,0,0,1
valhalla,0,0,1,0,0,0,1
fulgencio,1,0,0,0,0,0,1
hare,0,0,1,0,0,0,1
ellis island,1,0,0,0,0,0,1
stwike,0,0,1,0,0,0,1
melodies,0,0,1,0,0,0,1
fudd,0,0,1,0,0,0,1
wabbits,0,0,1,0,0,0,1
q.,0,0,1,0,0,0,1
typhoon,0,0,1,0,0,0,1
tannhäuser,0,0,1,0,0,0,1
endearment,0,0,1,0,0,0,1
wagnerian,0,0,1,0,0,0,1
gaffoor,0,0,1,0,0,0,1
ratnakar,0,0,1,0,0,0,1
maghrib,1,0,0,0,0,0,1
daycare,0,0,1,0,0,0,1
commercial,0,0,1,0,0,0,1
davis,0,0,1,0,0,0,1
rc,0,0,1,0,0,0,1
outing,0,0,1,0,0,0,1
pizza planet,0,0,1,0,0,0,1
asr,1,0,0,0,0,0,1
scud,0,0,1,0,0,0,1
puppy,0,0,1,0,0,0,1
synchronization,0,0,1,0,0,0,1
cavalier,0,0,1,0,0,0,1
dueling,0,0,1,0,0,0,1
deforest phonofilm,0,0,1,0,0,0,1
lina,0,0,1,0,0,0,1
contradiction,1,0,0,0,0,0,1
cosmo brown,0,0,1,0,0,0,1
lifeless,0,0,1,0,0,0,1
naim,1,0,0,0,0,0,1
microphone,0,0,1,0,0,0,1
shredder,0,0,1,0,0,0,1
dump,0,0,1,0,0,0,1
daisy,0,0,1,0,0,0,1
grill,0,0,1,0,0,0,1
arkham asylum,1,0,0,0,0,0,1
sunnyside,0,0,1,0,0,0,1
"old,{{cite",0,0,1,0,0,0,1
conveyor,0,0,1,0,0,0,1
"fajr , zohar , asr",1,0,0,0,0,0,1
chuckles the clown,0,0,1,0,0,0,1
jessie,0,0,1,0,0,0,1
backpack,0,0,1,0,0,0,1
slinky,0,0,1,0,0,0,1
chuckles,0,0,1,0,0,0,1
lotso,0,0,1,0,0,0,1
chatter,0,0,1,0,0,0,1
teasing,0,0,1,0,0,0,1
comden,0,0,1,0,0,0,1
respectability,0,0,1,0,0,0,1
deforest,0,0,1,0,0,0,1
fast,0,0,1,0,0,0,1
shawl,0,0,1,0,0,0,1
famine,0,0,1,0,0,0,1
embark,0,0,1,0,0,0,1
the bhagavad gita's,0,0,1,0,0,0,1
marco,0,0,1,0,0,0,1
downpour,0,0,1,0,0,0,1
isha,1,0,0,0,0,0,1
bhagavad,0,0,1,0,0,0,1
the guide raju,0,0,1,0,0,0,1
valmiki,0,0,1,0,0,0,1
fajr,1,0,0,0,0,0,1
swami,0,0,1,0,0,0,1
engulf,0,0,1,0,0,0,1
miscommunication,0,0,1,0,0,0,1
gilbert,0,0,1,0,0,0,1
simpson,0,0,1,0,0,0,1
monumental,0,0,1,0,0,0,1
monumental pictures,0,0,1,0,0,0,1
kissing,0,0,1,0,0,0,1
sync,0,0,1,0,0,0,1
diction,0,0,1,0,0,0,1
cosmo,0,0,1,0,0,0,1
r.f.,0,0,1,0,0,0,1
phonofilm,0,0,1,0,0,0,1
vapid,0,0,1,0,0,0,1
zohar,1,0,0,0,0,0,1
vitaphone,0,0,1,0,0,0,1
grating,0,0,1,0,0,0,1
protestation,0,0,1,0,0,0,1
31st,1,0,0,0,0,0,1
selden,0,0,1,0,0,0,1
buildup,0,0,1,0,0,0,1
lockwood,0,0,1,0,0,0,1
kedar,0,0,1,0,0,0,1
driving,0,0,1,0,0,0,1
indran,0,0,1,0,0,0,1
dslr,1,0,0,0,0,0,1
cohort,1,0,0,0,0,0,1
echoing,0,1,0,0,0,0,1
cinesound,0,1,0,0,0,0,1
monarch of the rails,0,1,0,0,0,0,1
hawkesbury,0,1,0,0,0,0,1
turntable,0,1,0,0,0,0,1
fireman,0,1,0,0,0,0,1
picton,0,1,0,0,0,0,1
orissa,0,0,1,0,0,0,1
enfield,0,1,0,0,0,0,1
trumped,1,0,0,0,0,0,1
flashlight,1,0,0,0,0,0,1
the new south wales rail transport museum,0,1,0,0,0,0,1
rails,0,1,0,0,0,0,1
"""abhayam",0,1,0,0,0,0,1
vinu,0,1,0,0,0,0,1
post-wwii,0,1,0,0,0,0,1
shiner,0,1,0,0,0,0,1
foreign,0,1,0,0,0,0,1
barack,0,1,0,0,0,0,1
omaar,0,1,0,0,0,0,1
granai,0,1,0,0,0,0,1
guy smallman,0,1,0,0,0,0,1
bernays,0,1,0,0,0,0,1
lawyers,0,1,0,0,0,0,1
glasgow,0,1,0,0,0,0,1
us assist,0,1,0,0,0,0,1
mainstream,0,1,0,0,0,0,1
monger,0,1,0,0,0,0,1
whitman,0,1,0,0,0,0,1
unsworth,0,1,0,0,0,0,1
somalia,0,1,0,0,0,0,1
post-gulf war,0,1,0,0,0,0,1
rather,0,1,0,0,0,0,1
mccord,0,1,0,0,0,0,1
gaylord,0,0,1,0,0,0,1
pinu,0,0,1,0,0,0,1
londoner,0,0,1,0,0,0,1
ogino,0,0,1,0,0,0,1
ask,0,0,1,0,0,0,1
haku,0,0,1,0,0,0,1
stonemason,1,0,0,0,0,0,1
kohaku,0,0,1,0,0,0,1
transforms,0,0,1,0,0,0,1
yubaba,0,0,1,0,0,0,1
boh,0,0,1,0,0,0,1
the kohaku river,0,0,1,0,0,0,1
riverbed,0,0,1,0,0,0,1
yōkai,0,0,1,0,0,0,1
biscuit,0,0,1,0,0,0,1
the taj mahal,0,0,1,0,0,0,1
anbe,0,0,1,0,0,0,1
growling,0,0,1,0,0,0,1
kandasamy padayachi,0,0,1,0,0,0,1
chihiro,0,0,1,0,0,0,1
sujata,1,0,0,0,0,0,1
kamles,0,0,1,0,0,0,1
pigpen,0,0,1,0,0,0,1
rajat,0,0,1,0,0,0,1
kamlesh,0,0,1,0,0,0,1
comedian,0,0,1,0,0,0,1
introvert,0,0,1,0,0,0,1
cashier - renu,0,0,1,0,0,0,1
renu,0,0,1,0,0,0,1
caricature,0,0,1,0,0,0,1
surabhi,0,0,1,0,0,0,1
surabhi telugu,0,0,1,0,0,0,1
dialog,0,0,1,0,0,0,1
tempts,0,0,1,0,0,0,1
zeniba,0,0,1,0,0,0,1
kamaji,0,0,1,0,0,0,1
jamayang,1,0,0,0,0,0,1
shikigami,0,0,1,0,0,0,1
mousa,0,1,0,0,0,0,1
cynthia,0,1,0,0,0,0,1
obama,0,1,0,0,0,0,1
ramesan nair,0,1,0,0,0,0,1
future.{{cite,0,1,0,0,0,0,1
lekha,0,1,0,0,0,0,1
insecurity,0,1,0,0,0,0,1
palestine,0,1,0,0,0,0,1
dahr,0,1,0,0,0,0,1
budget,0,1,0,0,0,0,1
ap,0,1,0,0,0,0,1
the 2003 invasion of iraq,0,1,0,0,0,0,1
jamail,0,1,0,0,0,0,1
manion,0,1,0,0,0,0,1
rupert,0,1,0,0,0,0,1
flotilla,0,1,0,0,0,0,1
hamer,0,1,0,0,0,0,1
cockburn,0,1,0,0,0,0,1
wmd,0,1,0,0,0,0,1
handicapping,0,1,0,0,0,0,1
ramesan,0,1,0,0,0,0,1
still,0,1,0,0,0,0,1
gist,0,1,0,0,0,0,1
boy scouts,0,1,0,0,0,0,1
dozier,0,1,0,0,0,0,1
the scouts of harlem |publisher2009-12-04,0,1,0,0,0,0,1
|publisher2009,0,1,0,0,0,0,1
afghan,1,0,0,0,0,0,1
crystal lake,0,1,0,0,0,0,1
harlem,0,1,0,0,0,0,1
scouts,0,1,0,0,0,0,1
sowah,0,1,0,0,0,0,1
abhijit,0,1,0,0,0,0,1
omission,0,1,0,0,0,0,1
impairment,0,1,0,0,0,0,1
familial alzheimer's,0,1,0,0,0,0,1
familial,0,1,0,0,0,0,1
uncertainty,0,1,0,0,0,0,1
assist,0,1,0,0,0,0,1
smallman,0,1,0,0,0,0,1
melvin,0,1,0,0,0,0,1
sanction,0,1,0,0,0,0,1
carne,0,1,0,0,0,0,1
rageh,0,1,0,0,0,0,1
the u.s. occupation of iraq,0,1,0,0,0,0,1
mckinney,0,1,0,0,0,0,1
colombia,0,1,0,0,0,0,1
newsgathering,0,1,0,0,0,0,1
precedent,0,1,0,0,0,0,1
hanley,0,1,0,0,0,0,1
bbc,0,1,0,0,0,0,1
public interest lawyers,0,1,0,0,0,0,1
gabe,1,0,0,0,0,0,1
itv,0,1,0,0,0,0,1
peacetime,0,1,0,0,0,0,1
itv news,0,1,0,0,0,0,1
wikileaks,0,1,0,0,0,0,1
british foreign office,0,1,0,0,0,0,1
claud,0,1,0,0,0,0,1
congresswoman,0,1,0,0,0,0,1
glasgow university media group’s,0,1,0,0,0,0,1
coverage,0,1,0,0,0,0,1
un,0,1,0,0,0,0,1
journalism,0,1,0,0,0,0,1
the armed forces memorial,0,1,0,0,0,0,1
eliza,1,0,0,0,0,0,1
baha,0,1,0,0,0,0,1
pilger,0,1,0,0,0,0,1
gaza,0,1,0,0,0,0,1
rendall,0,1,0,0,0,0,1
batty,1,0,0,0,0,0,1
yemen,0,1,0,0,0,0,1
philo,0,1,0,0,0,0,1
assange,0,1,0,0,0,0,1
cbs,0,1,0,0,0,0,1
ewen,0,1,0,0,0,0,1
sangu,0,0,1,0,0,0,1
mahal,0,0,1,0,0,0,1
cameo,0,0,1,0,0,0,1
shenzi,0,0,1,0,0,0,1
scar on pride rock,0,0,1,0,0,0,1
royalty,0,0,1,0,0,0,1
meerkat,0,0,1,0,0,0,1
sarabi,0,0,1,0,0,0,1
simba,0,0,1,0,0,0,1
warthog,0,0,1,0,0,0,1
rafiki,0,0,1,0,0,0,1
nala,0,0,1,0,0,0,1
phantasm,1,0,0,0,0,0,1
reconcile,0,0,1,0,0,0,1
matata,0,0,1,0,0,0,1
hakuna,0,0,1,0,0,0,1
mandrill,0,0,1,0,0,0,1
pumbaa,0,0,1,0,0,0,1
king mufasa,0,0,1,0,0,0,1
timon,0,0,1,0,0,0,1
banzai,0,0,1,0,0,0,1
hyena,0,0,1,0,0,0,1
cub,0,0,1,0,0,0,1
labi,0,0,1,0,0,0,1
belacan,0,0,1,0,0,0,1
bila,0,0,1,0,0,0,1
larut,0,0,1,0,0,0,1
labu,0,0,1,0,0,0,1
"chita, labu's",0,0,1,0,0,0,1
chita,0,0,1,0,0,0,1
primate,0,0,1,0,0,0,1
malay,0,0,1,0,0,0,1
chechen,1,0,0,0,0,0,1
saloma,0,0,1,0,0,0,1
vocal,0,0,1,0,0,0,1
bakhil,0,0,1,0,0,0,1
malam,0,0,1,0,0,0,1
ketok,0,0,1,0,0,0,1
tarzan,0,0,1,0,0,0,1
pride rock,0,0,1,0,0,0,1
the pride lands,0,0,1,0,0,0,1
lioness,0,0,1,0,0,0,1
compatriot,0,0,1,0,0,0,1
sarojini,0,0,1,0,0,0,1
ramachandramurthy,0,0,1,0,0,0,1
vinayagar,0,0,1,0,0,0,1
thesis,0,0,1,0,0,0,1
fundraiser,1,0,0,0,0,0,1
foolishness,0,0,1,0,0,0,1
kamal,0,0,1,0,0,0,1
arivudainambi,0,0,1,0,0,0,1
aiyampettai,0,0,1,0,0,0,1
chandran,0,0,1,0,0,0,1
tickling,0,0,1,0,0,0,1
rash,0,0,1,0,0,0,1
kaliyaperumal,0,0,1,0,0,0,1
nehru,0,0,1,0,0,0,1
doriasamy,0,0,1,0,0,0,1
meenakshi doriasamy,0,0,1,0,0,0,1
oxford,0,0,1,0,0,0,1
mufasa,0,0,1,0,0,0,1
homecoming,0,0,1,0,0,0,1
kausalya,0,0,1,0,0,0,1
vasanth,0,0,1,0,0,0,1
tagline,0,0,1,0,0,0,1
starting,0,0,1,0,0,0,1
rajastan,0,0,1,0,0,0,1
oxford university,0,0,1,0,0,0,1
sane,0,0,1,0,0,0,1
lau,1,0,0,0,0,0,1
the hollywood romantic comedy,0,0,1,0,0,0,1
travis,0,0,1,0,0,0,1
inversion,0,0,1,0,0,0,1
accountant,1,0,0,0,0,0,1
illumination,0,0,1,0,0,0,1
anglican,0,0,1,0,0,0,1
zealot,0,0,1,0,0,0,1
gambol,1,0,0,0,0,0,1
labu and labi,0,0,1,0,0,0,1
keris,0,0,1,0,0,0,1
uthaman,0,0,1,0,0,0,1
tashi,1,0,0,0,0,0,1
ab,0,0,1,0,0,0,1
sivam,0,0,1,0,0,0,1
bloodsick,0,0,1,0,0,0,1
cucumber,0,0,1,0,0,0,1
karma,1,0,0,0,0,0,1
unjust,0,0,1,0,0,0,1
bonus,0,0,1,0,0,0,1
sickle,0,0,1,0,0,0,1
monsoon,0,0,1,0,0,0,1
kandasamy,0,0,1,0,0,0,1
anbu,0,0,1,0,0,0,1
nalla,0,0,1,0,0,0,1
unionist,0,0,1,0,0,0,1
eid,0,0,1,0,0,0,1
aras,0,0,1,0,0,0,1
himalayan,1,0,0,0,0,0,1
diversity,0,0,1,0,0,0,1
consternation,0,0,1,0,0,0,1
slew,0,0,1,0,0,0,1
taj,0,0,1,0,0,0,1
optionless,0,0,1,0,0,0,1
bhubaneswar,0,0,1,0,0,0,1
anbarasu,0,0,1,0,0,0,1
increment,0,0,1,0,0,0,1
cheque,0,0,1,0,0,0,1
padayachi,0,0,1,0,0,0,1
pema,1,0,0,0,0,0,1
weeps,0,0,1,0,0,0,1
communism,0,0,1,0,0,0,1
inclement,0,0,1,0,0,0,1
nallasivam,0,0,1,0,0,0,1
industrialization,0,0,1,0,0,0,1
fervour,0,0,1,0,0,0,1
tribeca,0,0,1,0,0,0,1
dawa,1,0,0,0,0,0,1
ramlee,0,0,1,0,0,0,1
kumari,0,0,1,0,0,0,1
govt,0,0,1,0,0,0,1
yr,0,0,1,0,0,0,1
anr,0,0,1,0,0,0,1
svr,0,0,1,0,0,0,1
missiamma,0,0,1,0,0,0,1
profane,1,0,0,0,0,0,1
savithri,0,0,1,0,0,0,1
relangi,0,0,1,0,0,0,1
verandah,0,0,1,0,0,0,1
manisah,0,0,1,0,0,0,1
haji,0,0,1,0,0,0,1
firewood,0,0,1,0,0,0,1
ketampi,0,0,1,0,0,0,1
sarimah,0,0,1,0,0,0,1
bomoh,0,0,1,0,0,0,1
jamuna,0,0,1,0,0,0,1
ntr,0,0,1,0,0,0,1
closeup,0,0,1,0,0,0,1
mahalakshmi,0,0,1,0,0,0,1
stinker,0,0,1,0,0,0,1
perishes,1,0,0,0,0,0,1
windshield,0,0,1,0,0,0,1
yell,0,0,1,0,0,0,1
anvil,0,0,1,0,0,0,1
daffy,0,0,1,0,0,0,1
ducks,0,0,1,0,0,0,1
animator,0,0,1,0,0,0,1
screwball,0,0,1,0,0,0,1
scenery,0,0,1,0,0,0,1
alignment,0,0,1,0,0,0,1
daffy ducks,0,0,1,0,0,0,1
ai,0,0,1,0,0,0,1
foil,0,0,1,0,0,0,1
musketeer,0,0,1,0,0,0,1
packet,0,0,1,0,0,0,1
mastura,0,0,1,0,0,0,1
scarer,0,0,1,0,0,0,1
gulch,0,0,1,0,0,0,1
ponders,0,0,1,0,0,0,1
em,0,0,1,0,0,0,1
slipper,0,0,1,0,0,0,1
the wicked witch,0,0,1,0,0,0,1
cairn terrier,0,0,1,0,0,0,1
emerald,0,0,1,0,0,0,1
quartet,0,0,1,0,0,0,1
zeke,0,0,1,0,0,0,1
the good witch,0,0,1,0,0,0,1
the emerald city,0,0,1,0,0,0,1
toss,0,0,1,0,0,0,1
lakha,0,0,1,0,0,0,1
rainstorm,0,0,1,0,0,0,1
batsman,0,0,1,0,0,0,1
backpedals,0,0,1,0,0,0,1
lagaan,0,0,1,0,0,0,1
winkie,0,0,1,0,0,0,1
the yellow brick road,0,0,1,0,0,0,1
winkies,0,0,1,0,0,0,1
ding,0,0,1,0,0,0,1
munchkins,0,0,1,0,0,0,1
hickory,0,0,1,0,0,0,1
uproar,1,0,0,0,0,0,1
rizzi,1,0,0,0,0,0,1
the wicked witch of the east,0,0,1,0,0,0,1
glinda,0,0,1,0,0,0,1
pretty,0,0,1,0,0,0,1
cowardly,0,0,1,0,0,0,1
munchkinland,0,0,1,0,0,0,1
tornado,0,0,1,0,0,0,1
cairn,0,0,1,0,0,0,1
wizard of oz,0,0,1,0,0,0,1
removal,0,0,1,0,0,0,1
hunk,0,0,1,0,0,0,1
dong,0,0,1,0,0,0,1
hyman,1,0,0,0,0,0,1
champaner,0,0,1,0,0,0,1
central africa,0,0,1,0,0,0,1
striker,0,0,1,0,0,0,1
cantonment,0,0,1,0,0,0,1
umpire,0,0,1,0,0,0,1
rosatos,1,0,0,0,0,0,1
batting,0,0,1,0,0,0,1
grisha,0,0,1,0,0,0,1
massine,0,0,1,0,0,0,1
shoes&#34,0,0,1,0,0,0,1
easdale,0,0,1,0,0,0,1
ambiguity,0,0,1,0,0,0,1
since.{{cite,0,0,1,0,0,0,1
andersen,0,0,1,0,0,0,1
spate,1,0,0,0,0,0,1
cellophane,0,0,1,0,0,0,1
pentangeli,1,0,0,0,0,0,1
impresario,0,0,1,0,0,0,1
communion,1,0,0,0,0,0,1
bhuvan,0,0,1,0,0,0,1
the british empire,0,0,1,0,0,0,1
disbanding,0,0,1,0,0,0,1
kachra,0,0,1,0,0,0,1
ismail,0,0,1,0,0,0,1
heartbroken,0,0,1,0,0,0,1
boundary,0,0,1,0,0,0,1
"bhuvan, lakha",0,0,1,0,0,0,1
bhuvan offers,0,0,1,0,0,0,1
puran,0,0,1,0,0,0,1
inning,0,0,1,0,0,0,1
cricket,0,0,1,0,0,0,1
bowler,0,0,1,0,0,0,1
"russell, lakha",0,0,1,0,0,0,1
wicket,0,0,1,0,0,0,1
bhuvan of lakha's,0,0,1,0,0,0,1
the state of gujarat,0,0,1,0,0,0,1
gauri,0,0,1,0,0,0,1
wicked,0,0,1,0,0,0,1
broomstick,0,0,1,0,0,0,1
rajnikanth,0,0,1,0,0,0,1
rto,0,0,1,0,0,0,1
varmam,0,0,1,0,0,0,1
the indian national army,0,0,1,0,0,0,1
gandhikrishna,0,0,1,0,0,0,1
ina,0,0,1,0,0,0,1
paneerselvam,0,0,1,0,0,0,1
aishwarya,0,0,1,0,0,0,1
i.e.death,0,0,1,0,0,0,1
krishnaswamy,0,0,1,0,0,0,1
the wicked witch's,0,0,1,0,0,0,1
sapna,0,0,1,0,0,0,1
vesna,0,0,1,0,0,0,1
janja,0,0,1,0,0,0,1
slovenian,0,0,1,0,0,0,1
slovene,0,0,1,0,0,0,1
slavic,0,0,1,0,0,0,1
sandi and krištof,0,0,1,0,0,0,1
subhas,0,0,1,0,0,0,1
chandru,0,0,1,0,0,0,1
amirthavalli,0,0,1,0,0,0,1
bose,0,0,1,0,0,0,1
shivaram,0,0,1,0,0,0,1
karan singhania,0,0,1,0,0,0,1
the all india radio,0,0,1,0,0,0,1
sukhi,0,0,1,0,0,0,1
mig-21,0,0,1,0,0,0,1
rajnath,0,0,1,0,0,0,1
new delhi,0,0,1,0,0,0,1
laxman,0,0,1,0,0,0,1
sonia,0,0,1,0,0,0,1
rebellions,0,0,1,0,0,0,1
senapathy,0,0,1,0,0,0,1
sukanya,0,0,1,0,0,0,1
extremist,0,0,1,0,0,0,1
tag,0,0,1,0,0,0,1
subbiah,0,0,1,0,0,0,1
sandi,0,0,1,0,0,0,1
slovenian film fund,0,0,1,0,0,0,1
math,0,0,1,0,0,0,1
shenbaga,0,0,1,0,0,0,1
ganesha,0,0,1,0,0,0,1
nakeeran,0,0,1,0,0,0,1
bhagavathar,0,0,1,0,0,0,1
dharumi,0,0,1,0,0,0,1
dhatchan,0,0,1,0,0,0,1
thiruvilayadal,0,0,1,0,0,0,1
palam,0,0,1,0,0,0,1
nee,0,0,1,0,0,0,1
devotee,0,0,1,0,0,0,1
mahathandava,0,0,1,0,0,0,1
portmanteau,0,0,1,0,0,0,1
bestows,0,0,1,0,0,0,1
almira,0,0,1,0,0,0,1
marvel,0,0,1,0,0,0,1
parapet,0,0,1,0,0,0,1
hemanatha,0,0,1,0,0,0,1
muruga,0,0,1,0,0,0,1
krištof,0,0,1,0,0,0,1
mahayagna,0,0,1,0,0,0,1
samo,0,0,1,0,0,0,1
mind.plot,0,0,1,0,0,0,1
pandian,0,0,1,0,0,0,1
dhatchayini,0,0,1,0,0,0,1
lampone,1,0,0,0,0,0,1
pandya,0,0,1,0,0,0,1
thiruvilayadalgal,0,0,1,0,0,0,1
goddess parvathi,0,0,1,0,0,0,1
enrages,0,0,1,0,0,0,1
the pandya kingdom,0,0,1,0,0,0,1
thiruvilaiyadal,0,0,1,0,0,0,1
parvathi,0,0,1,0,0,0,1
kayarkanni,0,0,1,0,0,0,1
palani,0,0,1,0,0,0,1
durbar,0,0,1,0,0,0,1
the ballet lermontov,0,0,1,0,0,0,1
beecham,0,0,1,0,0,0,1
the ballet lemontov,0,0,1,0,0,0,1
debraj,0,0,1,0,0,0,1
cooking,0,0,1,0,0,0,1
colette,0,0,1,0,0,0,1
direktor,1,0,0,0,0,0,1
competence,0,0,1,0,0,0,1
ba,0,0,1,0,0,0,1
mcnally,0,0,1,0,0,0,1
l,0,0,1,0,0,0,1
typing,0,0,1,0,0,0,1
lemontov,0,0,1,0,0,0,1
michelle,0,0,1,0,0,0,1
continuation,0,0,1,0,0,0,1
sahai,0,0,1,0,0,0,1
alphabet,0,0,1,0,0,0,1
deaf,0,0,1,0,0,0,1
c,0,0,1,0,0,0,1
deficiency,0,0,1,0,0,0,1
toque,0,0,1,0,0,0,1
skylight,0,0,1,0,0,0,1
bistro,0,0,1,0,0,0,1
liam,1,0,0,0,0,0,1
mess,1,0,0,0,0,0,1
perch,0,0,1,0,0,0,1
raindrop,0,0,1,0,0,0,1
rating,0,0,1,0,0,0,1
soup,0,0,1,0,0,0,1
infestation,0,0,1,0,0,0,1
ratatouille,0,0,1,0,0,0,1
remy,0,0,1,0,0,0,1
gusteau,0,0,1,0,0,0,1
emile,0,0,1,0,0,0,1
linguini,0,0,1,0,0,0,1
marionette,0,0,1,0,0,0,1
tatou,0,0,1,0,0,0,1
gourmet,0,0,1,0,0,0,1
comprehension,0,0,1,0,0,0,1
enrollment,0,0,1,0,0,0,1
bachelor of arts,0,0,1,0,0,0,1
höß,1,0,0,0,0,0,1
chhoti,0,0,1,0,0,0,1
the brahmo samaj,0,0,1,0,0,0,1
confidante,0,0,1,0,0,0,1
brahmo,0,0,1,0,0,0,1
mohini sindoor,0,0,1,0,0,0,1
choudhury,0,0,1,0,0,0,1
choudhurys,0,0,1,0,0,0,1
bansi,0,0,1,0,0,0,1
sulley,0,0,1,0,0,0,1
monsters inc.,0,0,1,0,0,0,1
himalayas,0,0,1,0,0,0,1
waternoose,0,0,1,0,0,0,1
detection,0,0,1,0,0,0,1
"the monsters, inc.",0,0,1,0,0,0,1
celia,0,0,1,0,0,0,1
sock,0,0,1,0,0,0,1
schindler's,1,0,0,0,0,0,1
jaba,0,0,1,0,0,0,1
arts,0,0,1,0,0,0,1
samaj,0,0,1,0,0,0,1
liquidation,1,0,0,0,0,0,1
mcnallys,0,0,1,0,0,0,1
braille,0,0,1,0,0,0,1
debraj sahai,0,0,1,0,0,0,1
carrying,0,0,1,0,0,0,1
subinay,0,0,1,0,0,0,1
bahu,0,0,1,0,0,0,1
bhoothnath,0,0,1,0,0,0,1
majhle,0,0,1,0,0,0,1
buying,1,0,0,0,0,0,1
sindoor,0,0,1,0,0,0,1
rustic,0,0,1,0,0,0,1
zamindars,0,0,1,0,0,0,1
going,0,0,1,0,0,0,1
jewellery,0,0,1,0,0,0,1
catbus,0,0,1,0,0,0,1
kusakabe,0,0,1,0,0,0,1
corn,0,0,1,0,0,0,1
highlight,0,0,1,0,0,0,1
ramlal,0,0,1,0,0,0,1
cyclist,0,0,1,0,0,0,1
devika,0,0,1,0,0,0,1
lal,0,0,1,0,0,0,1
supportive,1,0,0,0,0,0,1
dehradun,0,0,1,0,0,0,1
multimillion,0,0,1,0,0,0,1
fancy,0,0,1,0,0,0,1
rajput,0,0,1,0,0,0,1
bunk,0,0,1,0,0,0,1
sanju,0,0,1,0,0,0,1
xaviers,0,0,1,0,0,0,1
ensue,0,0,1,0,0,0,1
shekhar,0,0,1,0,0,0,1
hangout,0,0,1,0,0,0,1
sanju and shekhar,0,0,1,0,0,0,1
software,0,0,1,0,0,0,1
enter,0,0,1,0,0,0,1
permit,0,0,1,0,0,0,1
léonide,0,0,1,0,0,0,1
choreographer,0,0,1,0,0,0,1
shoemaker,0,0,1,0,0,0,1
"lake,{{cite",0,0,1,0,0,0,1
company&#39;s,0,0,1,0,0,0,1
matinee,0,0,1,0,0,0,1
vicky,0,0,1,0,0,0,1
netherworld,0,0,1,0,0,0,1
ljubov,0,0,1,0,0,0,1
léonide massine,0,0,1,0,0,0,1
lermontov,0,0,1,0,0,0,1
kamesh,0,0,1,0,0,0,1
kameshwar,0,0,1,0,0,0,1
festa,1,0,0,0,0,0,1
deepak,0,0,1,0,0,0,1
queens,0,0,1,0,0,0,1
vidyasagar,0,0,1,0,0,0,1
windowsill,0,0,1,0,0,0,1
"ajay, gulfam",0,0,1,0,0,0,1
acp,0,0,1,0,0,0,1
arsenal,0,0,1,0,0,0,1
the special action team,0,0,1,0,0,0,1
thakur,0,0,1,0,0,0,1
mirchi,0,0,1,0,0,0,1
ghazal,0,0,1,0,0,0,1
clearing,0,0,1,0,0,0,1
habitat,0,0,1,0,0,0,1
dubbing,0,0,1,0,0,0,1
totoro,0,0,1,0,0,0,1
sprout,0,0,1,0,0,0,1
satsuki,0,0,1,0,0,0,1
mei,0,0,1,0,0,0,1
camphor,0,0,1,0,0,0,1
soot,0,0,1,0,0,0,1
consignment,0,0,1,0,0,0,1
special action team,0,0,1,0,0,0,1
ananthakrishnan,0,0,1,0,0,0,1
chandrapur,0,0,1,0,0,0,1
handicap,0,0,1,0,0,0,1
keyboard,0,0,1,0,0,0,1
archana,0,0,1,0,0,0,1
sheela,0,0,1,0,0,0,1
viji,0,0,1,0,0,0,1
baig,0,0,1,0,0,0,1
salim,0,0,1,0,0,0,1
bahid,0,0,1,0,0,0,1
partition,0,0,1,0,0,0,1
handler,0,0,1,0,0,0,1
acp ajay singh rathod,0,0,1,0,0,0,1
gulfam,0,0,1,0,0,0,1
rambandhu,0,0,1,0,0,0,1
gupt,0,0,1,0,0,0,1
embarks,0,0,1,0,0,0,1
the indian air force,0,0,1,0,0,0,1
baton,0,0,1,0,0,0,1
azad,0,0,1,0,0,0,1
champagne,0,0,1,0,0,0,1
vocalist,0,0,1,0,0,0,1
tahoe,1,0,0,0,0,0,1
spats,0,0,1,0,0,0,1
osgood,0,0,1,0,0,0,1
society syncopators,0,0,1,0,0,0,1
valentine,0,0,1,0,0,0,1
grant,0,0,1,0,0,0,1
cary,0,0,1,0,0,0,1
ndash}}dead,1,0,0,0,0,0,1
norway,0,0,1,0,0,0,1
processor,0,0,1,0,0,0,1
comedienne,0,0,1,0,0,0,1
interjection,0,0,1,0,0,0,1
serendipity,0,0,1,0,0,0,1
anantha,0,0,1,0,0,0,1
radhakrishna,0,0,1,0,0,0,1
friends,0,0,1,0,0,0,1
daphne,0,0,1,0,0,0,1
supper,0,0,1,0,0,0,1
colombo,0,0,1,0,0,0,1
blurts,0,0,1,0,0,0,1
shekar,0,0,1,0,0,0,1
sekhar,0,0,1,0,0,0,1
shell oil,0,0,1,0,0,0,1
choosing,0,0,1,0,0,0,1
saxophone,0,0,1,0,0,0,1
beanstock,0,0,1,0,0,0,1
the saint valentine's,0,0,1,0,0,0,1
fielding,0,0,1,0,0,0,1
onshore,0,0,1,0,0,0,1
syncopators,0,0,1,0,0,0,1
ukulele,0,0,1,0,0,0,1
onstage,0,0,1,0,0,0,1
yacht,0,0,1,0,0,0,1
havana,1,0,0,0,0,0,1
the government of india,0,0,1,0,0,0,1
gangadhar,0,0,1,0,0,0,1
auditorium,0,0,1,0,0,0,1
peeping,0,0,1,0,0,0,1
entrap,0,0,1,0,0,0,1
aravid,0,0,1,0,0,0,1
addala,0,0,1,0,0,0,1
arvind,0,0,1,0,0,0,1
hairstyle,0,0,1,0,0,0,1
infancy,0,0,1,0,0,0,1
siddhu,0,0,1,0,0,0,1
deepens,0,0,1,0,0,0,1
satti,0,0,1,0,0,0,1
kanaka,0,0,1,0,0,0,1
say,0,0,1,0,0,0,1
hasini,0,0,1,0,0,0,1
protectiveness,0,0,1,0,0,0,1
managing,0,0,1,0,0,0,1
fanucci,1,0,0,0,0,0,1
suliman,0,0,1,0,0,0,1
calcifer,0,0,1,0,0,0,1
shri,0,0,1,0,0,0,1
heen,0,0,1,0,0,0,1
awardees,0,0,1,0,0,0,1
sangeeta,0,0,1,0,0,0,1
samrat,0,0,1,0,0,0,1
ananta,0,0,1,0,0,0,1
prodigy,0,0,1,0,0,0,1
basic,0,0,1,0,0,0,1
cleaning,0,0,1,0,0,0,1
plotter,1,0,0,0,0,0,1
witch of the waste,0,0,1,0,0,0,1
sophie,0,0,1,0,0,0,1
wastes,0,0,1,0,0,0,1
bug,0,0,1,0,0,0,1
hatter,0,0,1,0,0,0,1
ndash}}saying,1,0,0,0,0,0,1
the witch for howl's,0,0,1,0,0,0,1
clamor,0,0,1,0,0,0,1
new year’s eve,0,0,1,0,0,0,1
chitra,0,0,1,0,0,0,1
the flying scissors,0,0,1,0,0,0,1
dissolve,1,0,0,0,0,0,1
ishaan,0,0,1,0,0,0,1
awasthi,0,0,1,0,0,0,1
yohaan,0,0,1,0,0,0,1
instructor,0,0,1,0,0,0,1
lalita,0,0,1,0,0,0,1
nikumbh,0,0,1,0,0,0,1
dyslexia,0,0,1,0,0,0,1
rajan,0,0,1,0,0,0,1
shortcoming,0,0,1,0,0,0,1
nandkishore,0,0,1,0,0,0,1
the tulips school,0,0,1,0,0,0,1
andolini,1,0,0,0,0,0,1
lajmi,0,0,1,0,0,0,1
tulips,0,0,1,0,0,0,1
rock paper scissors,0,0,1,0,0,0,1
nuance,0,0,1,0,0,0,1
tutoring,0,0,1,0,0,0,1
diganth,0,0,1,0,0,0,1
balachandar,0,0,1,0,0,0,1
jayalaksmi,0,0,1,0,0,0,1
phataphat,0,0,1,0,0,0,1
saritha,0,0,1,0,0,0,1
sreedevi,0,0,1,0,0,0,1
ammaduand,0,0,1,0,0,0,1
kiranmayi,0,0,1,0,0,0,1
shakthi,0,0,1,0,0,0,1
category,0,0,1,0,0,0,1
kodandaram,0,0,1,0,0,0,1
sowmya,0,0,1,0,0,0,1
pavani,0,0,1,0,0,0,1
kitty,0,0,1,0,0,0,1
diganth-radha,0,0,1,0,0,0,1
mugilupete,0,0,1,0,0,0,1
strangles,1,0,0,0,0,0,1
midday,0,0,1,0,0,0,1
anu,0,0,1,0,0,0,1
nasa,0,0,1,0,0,0,1
gayatri,0,0,1,0,0,0,1
postmaster,0,0,1,0,0,0,1
reservoir,0,0,1,0,0,0,1
kodi,0,0,1,0,0,0,1
the university of pennsylvania,0,0,1,0,0,0,1
hydro,0,0,1,0,0,0,1
neri,1,0,0,0,0,0,1
charanpur,0,0,1,0,0,0,1
sensitivity,0,0,1,0,0,0,1
where kaveri amma,0,0,1,0,0,0,1
kaveri,0,0,1,0,0,0,1
dhaba,0,0,1,0,0,0,1
non-resident indian,0,0,1,0,0,0,1
due,0,0,1,0,0,0,1
amma,0,0,1,0,0,0,1
joshi,0,0,1,0,0,0,1
bhargava,0,0,1,0,0,0,1
sneaker,0,0,1,0,0,0,1
illiteracy,0,0,1,0,0,0,1
lake tahoe,1,0,0,0,0,0,1
glance,1,0,0,0,0,0,1
homework,0,0,1,0,0,0,1
footrace,0,0,1,0,0,0,1
grocer,0,0,1,0,0,0,1
zahra,0,0,1,0,0,0,1
south tehran,0,0,1,0,0,0,1
roya,0,0,1,0,0,0,1
gardening,0,0,1,0,0,0,1
north tehran,0,0,1,0,0,0,1
garbageman,0,0,1,0,0,0,1
elation,0,0,1,0,0,0,1
alireza,0,0,1,0,0,0,1
turbine,0,0,1,0,0,0,1
haridas,0,0,1,0,0,0,1
rosato,1,0,0,0,0,0,1
bloat,0,0,1,0,0,0,1
ashfaqulla,0,0,1,0,0,0,1
gauleiter,0,0,1,0,0,0,1
drape,0,0,1,0,0,0,1
trapps,0,0,1,0,0,0,1
plug,0,0,1,0,0,0,1
reprise,0,0,1,0,0,0,1
ev'ry,0,0,1,0,0,0,1
the nazi gauleiter,0,0,1,0,0,0,1
zeller,0,0,1,0,0,0,1
the salzburg festival,0,0,1,0,0,0,1
"the ""tank gang""",0,0,1,0,0,0,1
trapp,0,0,1,0,0,0,1
goodnight,0,0,1,0,0,0,1
geary,1,0,0,0,0,0,1
the salzburg cathedral,0,0,1,0,0,0,1
sixteen,0,0,1,0,0,0,1
nazism,0,0,1,0,0,0,1
baroness,0,0,1,0,0,0,1
salzburg music festival,0,0,1,0,0,0,1
shipshape,0,0,1,0,0,0,1
detweiler,0,0,1,0,0,0,1
liesl,0,0,1,0,0,0,1
patronage,0,0,1,0,0,0,1
nonnberg,0,0,1,0,0,0,1
alps,0,0,1,0,0,0,1
the salzburg music festival,0,0,1,0,0,0,1
governess,0,0,1,0,0,0,1
blush,0,0,1,0,0,0,1
naval,0,0,1,0,0,0,1
mischief,0,0,1,0,0,0,1
laendler,0,0,1,0,0,0,1
gazebo,0,0,1,0,0,0,1
anschluss,0,0,1,0,0,0,1
ignition,0,0,1,0,0,0,1
sewing,0,0,1,0,0,0,1
austrian navy captain,0,0,1,0,0,0,1
the nazi naval headquarters,0,0,1,0,0,0,1
seventeen,0,0,1,0,0,0,1
bremerhaven,0,0,1,0,0,0,1
the box &,0,0,1,0,0,0,1
archenemies,0,0,1,0,0,0,1
dj,0,0,1,0,0,0,1
ebb,0,0,1,0,0,0,1
daljit,0,0,1,0,0,0,1
mckinley,0,0,1,0,0,0,1
singhania,0,0,1,0,0,0,1
bhagat singh,0,0,1,0,0,0,1
tommasino,1,0,0,0,0,0,1
sukhi ram,0,0,1,0,0,0,1
rajguru,0,0,1,0,0,0,1
chandrasekhar,0,0,1,0,0,0,1
bhagat,0,0,1,0,0,0,1
the institute for international studies,0,0,1,0,0,0,1
vitality,0,0,1,0,0,0,1
the university of delhi,0,0,1,0,0,0,1
bismil,0,0,1,0,0,0,1
anti-muslim,0,0,1,0,0,0,1
the imperial police,0,0,1,0,0,0,1
raghunandan,0,0,1,0,0,0,1
revolutionary,0,0,1,0,0,0,1
amitabh,0,0,1,0,0,0,1
amitabh bachchan,0,0,1,0,0,0,1
tangle,0,0,1,0,0,0,1
bachchan,0,0,1,0,0,0,1
brink,0,0,1,0,0,0,1
daduji,0,0,1,0,0,0,1
grossing,0,0,1,0,0,0,1
niwas,0,0,1,0,0,0,1
shanti niwas & its,0,0,1,0,0,0,1
foyer,1,0,0,0,0,0,1
saviour,0,0,1,0,0,0,1
irony,0,0,1,0,0,0,1
shanti,0,0,1,0,0,0,1
studies,0,0,1,0,0,0,1
pandey,0,0,1,0,0,0,1
clinch,0,0,1,0,0,0,1
postulant,0,0,1,0,0,0,1
abbess,0,0,1,0,0,0,1
coral,0,0,1,0,0,0,1
mako,0,0,1,0,0,0,1
goldfish,0,0,1,0,0,0,1
tech,0,0,1,0,0,0,1
gramma,0,0,1,0,0,0,1
clownfish,0,0,1,0,0,0,1
drainpipe,0,0,1,0,0,0,1
batista,1,0,0,0,0,0,1
turtle,0,0,1,0,0,0,1
chum,0,0,1,0,0,0,1
pelican,0,0,1,0,0,0,1
regal,0,0,1,0,0,0,1
darla,0,0,1,0,0,0,1
deb,0,0,1,0,0,0,1
starfish,0,0,1,0,0,0,1
vito andolini’s,1,0,0,0,0,0,1
ola,1,0,0,0,0,0,1
blacktailed,0,0,1,0,0,0,1
scuba,0,0,1,0,0,0,1
hammerhead,0,0,1,0,0,0,1
anglerfish,0,0,1,0,0,0,1
scent,0,0,1,0,0,0,1
seagull,0,0,1,0,0,0,1
moonfish,0,0,1,0,0,0,1
dory,0,0,1,0,0,0,1
tang,0,0,1,0,0,0,1
the east australian current,0,0,1,0,0,0,1
nigel,0,0,1,0,0,0,1
grouper,0,0,1,0,0,0,1
gurgle,0,0,1,0,0,0,1
the new caledonia barrier reef,0,0,1,0,0,0,1
humbug,0,0,1,0,0,0,1
filter,0,0,1,0,0,0,1
blowhole,0,0,1,0,0,0,1
peach,0,0,1,0,0,0,1
marlin,0,0,1,0,0,0,1
caledonia,0,0,1,0,0,0,1
the german navy,0,0,1,0,0,0,1
mizandari,0,0,1,0,0,0,1
khachikyan,0,0,1,0,0,0,1
tu-144,0,0,1,0,0,0,1
armenian,0,0,1,0,0,0,1
falcon,0,0,1,0,0,0,1
moscow,0,0,1,0,0,0,1
tupolev,0,0,1,0,0,0,1
jagadeesh,0,0,1,0,0,0,1
enlargement,0,0,1,0,0,0,1
vishnuvardhan,0,0,1,0,0,0,1
suhasini,0,0,1,0,0,0,1
ciccio,1,0,0,0,0,0,1
nonnberg abbey,0,0,1,0,0,0,1
mother abbess,0,0,1,0,0,0,1
playclothes,0,0,1,0,0,0,1
pasture,0,0,1,0,0,0,1
valiko,0,0,1,0,0,0,1
telavi,0,0,1,0,0,0,1
puffer,0,0,1,0,0,0,1
hawk,0,0,1,0,0,0,1
jellyfish,0,0,1,0,0,0,1
fin,0,0,1,0,0,0,1
danker,0,0,1,0,0,0,1
get,0,0,1,0,0,0,1
spouse,0,0,1,0,0,0,1
exclusive,0,0,1,0,0,0,1
roth,1,0,0,0,0,0,1
warne,0,0,1,0,0,0,1
disdain,0,0,1,0,0,0,1
bombayite,0,0,1,0,0,0,1
oriya,0,0,1,0,0,0,1
mimino,0,0,1,0,0,0,1
homesick,0,0,1,0,0,0,1
georgian,0,0,1,0,0,0,1
roobik,0,0,1,0,0,0,1
watson,0,0,0,0,0,1,1
